WWWWWWWWWWWWWWWW
WWWWWWWWWWWWWWWW
WWFFFFFFFFFFFFWW
WWFFFFFBFFFFFFWW
WDFFFFBFBFFFFFWW
WDFFFBFSFBFFFFWW
WDFFFFBFBFFFFFWW
WWFFFFFBFFFFFFWW
WWFFFFFFFFFFFFWW
WWWWWWWWWWWWWWWW
WWWWWWWWWWWWWWWW