WWWWWWWWWWWWWWWW
WWWWWWWDDWWWWWWW
WWBBBBBFFFFFFFWW
WWBBBFFFFFFFFFWW
WDBBFFFFFFFFFFWW
WDFFFFFFFFFFFFWW
WDBBFFFFFFFFFFWW
WWBBBFFFFFFFFFWW
WWBBBBBFFFFFFFWW
WWWWWWWWWWWWWWWW
WWWWWWWWWWWWWWWW