WWWWWWWWWWWWWWWW
WWWWWWWWWWWWWWWW
WWBBBBBFFFFFFFWW
WWBBBFFFFFFFFFWW
WDBBFFFFFFFFFFWW
WDFFFFFFFFFFFFWW
WDBBFFFFFFFFFFWW
WWBBBFFFFFFFFFWW
WWBBBBBFFFFFFFWW
WWWWWWWDDWWWWWWW
WWWWWWWWWWWWWWWW