WWWWWWWWWWWWWWWW
WWWWWWWWWWWWWWWW
WWFFFFFFFFFFFFWW
WWFBBBBFFBBBBFWW
WWFBFFFFFFFFBFDW
WWFBFMFFFFMFBFDW
WWFBFFMFFMFFBFDW
WWFBBBBBBBBBBFWW
WWFFFFFFFFFFFFWW
WWWWWWWWWWWWWWWW
WWWWWWWWWWWWWWWW