WWWWWWWWWWWWWWWW
WWWWWWWWWWWWWWWW
WWFFFFFFFFFFFFWW
WWFPPPFFFFPPPFWW
WWFPFFFFFFFFPFDW
WWFPFPPPPPPFPFDW
WWFPFFFFFFFFPFDW
WWFPPPFFFFPPPFWW
WWFFFFFFFFFFFFWW
WWWWWWWDDWWWWWWW
WWWWWWWWWWWWWWWW