WWWWWWWWWWWWWWWW
WWWWWWWDDWWWWWWW
WWFFFFFFFBBBBBWW
WWFFFFFFFFFBBBWW
WWFFFFFFFFFFBBDW
WWFFFFFFFFFFFFDW
WWFFFFFFFFFFBBDW
WWFFFFFFFFFBBBWW
WWFFFFFFFBBBBBWW
WWWWWWWWWWWWWWWW
WWWWWWWWWWWWWWWW