WWWWWWWWWWWWWWWW
WWWWWWWWWWWWWWWW
WWFFFFFFFFFFFFWW
WWFFBFFFFFFBFFWW
WWFFFFFFFFFFFFDW
WWFFFFFFFFFFFFDW
WWFFFFFFFFFFFFDW
WWFFBFFFFFFBFFWW
WWFFFFFFFFFFFFWW
WWWWWWWWWWWWWWWW
WWWWWWWWWWWWWWWW