WWWWWWWWWWWWWWWW
WWWWWWWDDWWWWWWW
WWFFFFFFFFFFFFWW
WWFMFFMFFMFFMFWW
WDFFFFFFFFFFFFDW
WDFMFFMFFMFFMFDW
WDFFFFFOOFFFFFDW
WWFMFOMOOMOFMFWW
WWFFFOOOOOOFFFWW
WWWWWWWDDWWWWWWW
WWWWWWWWWWWWWWWW