WWWWWWWWWWWWWWWW
WWWWWWWDDWWWWWWW
WWFFFFFFFFFFFFWW
WWFMFFMFFMFFMFWW
WWFFFFFFFFFFFFDW
WWFMFFMFFMFFMFDW
WWFFFFFOOFFFFFDW
WWFMFOMOOMOFMFWW
WWFFFOOOOOOFFFWW
WWWWWWWDDWWWWWWW
WWWWWWWWWWWWWWWW