WWWWWWWWWWWWWWWW
WWWWWWWDDWWWWWWW
WWFFFFFFFFFFFFWW
WWFPPPFFFFPPPFWW
WDFPFFFFFFFFPFWW
WDFPFPPPPPPFPFWW
WDFPFFFFFFFFPFWW
WWFPPPFFFFPPPFWW
WWFFFFFFFFFFFFWW
WWWWWWWDDWWWWWWW
WWWWWWWWWWWWWWWW