WWWWWWWWWWWWWWWW
WWWWWWWDDWWWWWWW
WWFFFFFFFFFFFFWW
WWFBBBBFFBBBBFWW
WWFBFFFFFFFFBFWW
WWFBFMFFFFMFBFWW
WWFBFFMFFMFFBFWW
WWFBBBBBBBBBBFWW
WWFFFFFFFFFFFFWW
WWWWWWWWWWWWWWWW
WWWWWWWWWWWWWWWW