WWWWWWWWWWWWWWWW
WWWWWWWDDWWWWWWW
WWFFFFFFFFFFFFWW
WWFFBFFFFFFBFFWW
WWFFFFFFFFFFFFWW
WWFFFFFFFFFFFFWW
WWBBFFFFFFFFBBWW
WWBBBBFFFFBBBBWW
WWBBBBBFFBBBBBWW
WWWWWWWDDWWWWWWW
WWWWWWWWWWWWWWWW