WWWWWWWWWWWWWWWW
WWWWWWWWWWWWWWWW
WWFFFFFFFFFFBFWW
WWFBBBBBBBBFBFWW
WWFBFFFFFSBFBFWW
WWFBFFFBBBBFBFWW
WWFBFFFFFFFFBFWW
WWFBBBBBBBBBBFWW
WWFFFFFFFFFFFFWW
WWWWWWWWWWWWWWWW
WWWWWWWWWWWWWWWW