WWWWWWWWWWWWWWWW
WWWWWWWWWWWWWWWW
WWBBBBFFFFFFFFWW
WWBBBBFFFFFFFFWW
WWBBBFFFFFFFFFWW
WWSFFFFFFFFFFFWW
WWBBBFFFFFFFFFWW
WWBBBBFFFFFFFFWW
WWBBBBFFFFFFFFWW
WWWWWWWDDWWWWWWW
WWWWWWWWWWWWWWWW