WWWWWWWWWWWWWWWW
WWWWWWWWWWWWWWWW
WWFFFFFFFFFFFFWW
WWFBBBBBBBBBBFWW
WWFBFFMFFMFFBFWW
WWFBFMFFFFMFBFWW
WWFBFFFFFFFFBFWW
WWFBBBBFFBBBBFWW
WWFFFFFFFFFFFFWW
WWWWWWWDDWWWWWWW
WWWWWWWWWWWWWWWW