WWWWWWWWWWWWWWWW
WWWWWWWWWWWWWWWW
WWFFFFFFFFFFFFWW
WWFBFBFBBFBFBFWW
WDFFFFFFFFFFFFDW
WDFBFBFBBFBFBFDW
WDFFFFFFFFFFFFDW
WWFBFBFBBFBFBFWW
WWFFFFFFFFFFFFWW
WWWWWWWWWWWWWWWW
WWWWWWWWWWWWWWWW