WWWWWWWWWWWWWWWW
WWWWWWWWWWWWWWWW
WWFFFFFFFFFFFFWW
WWFBBBBBBBBBBFWW
WWFBFFFFFFFFBFWW
WWFBFBBBBFFFBFWW
WWFBFBSFFFFFBFWW
WWFBFBBBBBBBBFWW
WWFBFFFFFFFFFFWW
WWWWWWWWWWWWWWWW
WWWWWWWWWWWWWWWW