WWWWWWWWWWWWWWWW
WWWWWWWWWWWWWWWW
WWFFFFFFFFBBBBWW
WWFFFFFFFFBBBBWW
WWFFFFFFFFFBBBWW
WWFFFFFFFFFFFSWW
WWFFFFFFFFFBBBWW
WWFFFFFFFFBBBBWW
WWFFFFFFFFBBBBWW
WWWWWWWDDWWWWWWW
WWWWWWWWWWWWWWWW