WWWWWWWWWWWWWWWW
WWWWWWWDDWWWWWWW
WWFFFFFFFFBBBBWW
WWFFFFFFFFBBBBWW
WWFFFFFFFFFBBBWW
WWFFFFFFFFFFFSWW
WWFFFFFFFFFBBBWW
WWFFFFFFFFBBBBWW
WWFFFFFFFFBBBBWW
WWWWWWWWWWWWWWWW
WWWWWWWWWWWWWWWW