WWWWWWWWWWWWWWWW
WWWWWWWWWWWWWWWW
WWFFFFFFFFFFFFWW
WWFFFFFFFFFFFFWW
WDFFFFFFFFFFFFDW
WDFFFFFFFFFFFFDW
WDFFFFFFFFFFFFDW
WWFFFFFFFFFFFFWW
WWFFFFFFFFFFFFWW
WWWWWWWDDWWWWWWW
WWWWWWWWWWWWWWWW