WWWWWWWWWWWWWWWW
WWWWWWWWWWWWWWWW
WWFFFFFFFFFFFFWW
WWFBBFFFFFFBBFWW
WDFFFFFFFFFFFFWW
WDFFFFFBBFFFFFWW
WDFFFFFFFFFFFFWW
WWFBBFFFFFFBBFWW
WWFFFFFFFFFFFFWW
WWWWWWWDDWWWWWWW
WWWWWWWWWWWWWWWW