WWWWWWWWWWWWWWWW
WWWWWWWWWWWWWWWW
WWFFFFFFFFFFFFWW
WWFBBFFFFFFBBFWW
WWFFFFFFFFFFFFDW
WWFFFFFBBFFFFFDW
WWFFFFFFFFFFFFDW
WWFBBFFFFFFBBFWW
WWFFFFFFFFFFFFWW
WWWWWWWDDWWWWWWW
WWWWWWWWWWWWWWWW