WWWWWWWWWWWWWWWW
WWWWWWWDDWWWWWWW
WWFFFFFFFFFFFFWW
WWFFFFFFFFFFFFWW
WWFFFFFFFFFFFFWW
WWFFFFBFFBFFFFWW
WWFFFFFFFFFFFFWW
WWFFFFFFFFFFFFWW
WWFFFFFFFFFFFFWW
WWWWWWWDDWWWWWWW
WWWWWWWWWWWWWWWW