WWWWWWWWWWWWWWWW
WWWWWWWDDWWWWWWW
WWBBBBBFFBBBBBWW
WWBBBBFFFFBBBBWW
WDBBFFFFFFFFBBWW
WDFFFFFFFFFFFFWW
WDFFFFFFFFFFFFWW
WWFFBFFFFFFBFFWW
WWFFFFFFFFFFFFWW
WWWWWWWWWWWWWWWW
WWWWWWWWWWWWWWWW