WWWWWWWWWWWWWWWW
WWWWWWWWWWWWWWWW
WWFFFFFFFFFFFFWW
WWFPPPPPPPPPPFWW
WWFPPPPPPPPPPFDW
WWFPPFFFFFFPPFDW
WWFPPFFFFFFPPFDW
WWFPPPPFFPPPPFWW
WWFPPPPFFPPPPFWW
WWWWWWWDDWWWWWWW
WWWWWWWWWWWWWWWW