WWWWWWWWWWWWWWWW
WWWWWWWWWWWWWWWW
WWFFFFFFFFFFFFWW
WWFFFFFFFFFFFFWW
WDFFIFFFFFFIFFWW
WDFIFFFFFFFFIFWW
WDFFIFFFFFFIFFWW
WWFFFFFFFFFFFFWW
WWFFFFFFFFFFFFWW
WWWWWWWDDWWWWWWW
WWWWWWWWWWWWWWWW