WWWWWWWWWWWWWWWW
WWWWWWWWWWWWWWWW
WWPPPPPFFPPPPPWW
WWPFFFPFFFFPFPWW
WDPFPFPFPPFPFPDW
WDFFPFPFFPFPFFDW
WDPFPFPPFPFPFPDW
WWPFPFFFFPFFFPWW
WWPPPPPFFPPPPPWW
WWWWWWWDDWWWWWWW
WWWWWWWWWWWWWWWW