WWWWWWWWWWWWWWWW
WWWWWWWDDWWWWWWW
WWFFIFFFFFFFFIWW
WWFIFFFIFFFFIFWW
WWFFFFIFFFFIFFDW
WWFFFIFFFFIFFFDW
WWFFIFFFFIFFFFDW
WWFIFFFFIFFFIFWW
WWIFFFFFFFFIFFWW
WWWWWWWWWWWWWWWW
WWWWWWWWWWWWWWWW