WWWWWWWWWWWWWWWW
WWWWWWWWWWWWWWWW
WWFFFFFFFFIFIFWW
WWFFIIIFIIIFIFWW
WWIIIFFFIFFFIFDW
WWFFIFFFIFIFIFDW
WWFFIFFFIFIIIFDW
WWIFIFIFIFFFFFWW
WWIFFFIFFFFIFFWW
WWWWWWWWWWWWWWWW
WWWWWWWWWWWWWWWW