WWWWWWWWWWWWWWWW
WWWWWWWWWWWWWWWW
WWFFFFFFFFFFFFWW
WWFPPPPPPPPPPFWW
WDFPPPPPPPPPPFWW
WDFPPFFFFFFPPFWW
WDFPPFFFFFFPPFWW
WWFPPPPFFPPPPFWW
WWFPPPPFFPPPPFWW
WWWWWWWDDWWWWWWW
WWWWWWWWWWWWWWWW