WWWWWWWWWWWWWWWW
WWWWWWWWWWWWWWWW
WWPPPPPFFPPPPPWW
WWPFPFFFFPFFFPWW
WDPFPFPPFPFPFPDW
WDFFPFPFFPFPFFDW
WDPFPFPFPPFPFPDW
WWPFFFPFFFFPFPWW
WWPPPPPFFPPPPPWW
WWWWWWWDDWWWWWWW
WWWWWWWWWWWWWWWW