WWWWWWWWWWWWWWWW
WWWWWWWWWWWWWWWW
WWFFIFFFFFFFFIWW
WWFIFFFIFFFFIFWW
WDFFFFIFFFFIFFWW
WDFFFIFFFFIFFFWW
WDFFIFFFFIFFFFWW
WWFIFFFFIFFFIFWW
WWIFFFFFFFFIFFWW
WWWWWWWDDWWWWWWW
WWWWWWWWWWWWWWWW