WWWWWWWWWWWWWWWW
WWWWWWWWWWWWWWWW
WWPPPPPFFPPPPPWW
WWPFFFPPPPFFFPWW
WDPFPPPFFPPPFPDW
WDFFPFFFFFFPFFDW
WDPFPPPFFPPPFPDW
WWPFFFPPPPFFFPWW
WWPPPPPFFPPPPPWW
WWWWWWWWWWWWWWWW
WWWWWWWWWWWWWWWW