WWWWWWWWWWWWWWWW
WWWWWWWWWWWWWWWW
WWFIFIFFFFFFFFWW
WWFIFIIIFIIIFFWW
WDFIFFFIFFFIIIWW
WDFIFIFIFFFIFFWW
WDFIIIFIFFFIFFWW
WWFFFFFIFIFIFIWW
WWFFIFFFFIFFFIWW
WWWWWWWWWWWWWWWW
WWWWWWWWWWWWWWWW