WWWWWWWWWWWWWWWW
WWWWWWWWWWWWWWWW
WWIFFFFFFFFIFFWW
WWFIFFFFIFFFIFWW
WDFFIFFFFIFFFFWW
WDFFFIFFFFIFFFWW
WDFFFFIFFFFIFFWW
WWFIFFFIFFFFIFWW
WWFFIFFFFFFFFIWW
WWWWWWWWWWWWWWWW
WWWWWWWWWWWWWWWW