WWWWWWWWWWWWWWWW
WWWWWWWDDWWWWWWW
WWBFFFBFFFFBFFWW
WWBFBFBFBFFFFFWW
WWFFBFFFBFBBBFDW
WWFFBFFFBFBFBFDW
WWBBBFFFBFFFBFDW
WWFFBBBFBBBFBFWW
WWFFFFFFFFBFBFWW
WWWWWWWWWWWWWWWW
WWWWWWWWWWWWWWWW