WWWWWWWWWWWWWWWW
WWWWWWWDDWWWWWWW
WWFFFFFFFFFFFFWW
WWFIIFFFFFFIIFWW
WWFFFFFFFFFFFFDW
WWFFFFFIIFFFFFDW
WWFFFFFFFFFFFFDW
WWFIIFFFFFFIIFWW
WWFFFFFFFFFFFFWW
WWWWWWWDDWWWWWWW
WWWWWWWWWWWWWWWW