WWWWWWWWWWWWWWWW
WWWWWWWWWWWWWWWW
WWFFFFFFFBBBBBWW
WWFFFFFFFFFBBBWW
WDFFFFFFFFFFBBDW
WDFFFFFFFFFFFFDW
WDFFFFFFFFFFBBDW
WWFFFFFFFFFBBBWW
WWFFFFFFFBBBBBWW
WWWWWWWWWWWWWWWW
WWWWWWWWWWWWWWWW