WWWWWWWWWWWWWWWW
WWWWWWWDDWWWWWWW
WWPPPPPFFPPPPPWW
WWPFFFPFFFFPFPWW
WDPFPFPFPPFPFPWW
WDFFPFPFFPFPFFWW
WDPFPFPPFPFPFPWW
WWPFPFFFFPFFFPWW
WWPPPPPFFPPPPPWW
WWWWWWWWWWWWWWWW
WWWWWWWWWWWWWWWW