WWWWWWWWWWWWWWWW
WWWWWWWWWWWWWWWW
WWFFFFFFFFFFFFWW
WWFBFBFBBFBFBFWW
WDFFFFFFFFFFFFWW
WDFBFBFBBFBFBFWW
WDFFFFFFFFFFFFWW
WWFBFBFBBFBFBFWW
WWFFFFFFFFFFFFWW
WWWWWWWWWWWWWWWW
WWWWWWWWWWWWWWWW