WWWWWWWWWWWWWWWW
WWWWWWWDDWWWWWWW
WWPPPPPFFPPPPPWW
WWPFPFFFFPFFFPWW
WWPFPFPPFPFPFPDW
WWFFPFPFFPFPFFDW
WWPFPFPFPPFPFPDW
WWPFFFPFFFFPFPWW
WWPPPPPFFPPPPPWW
WWWWWWWWWWWWWWWW
WWWWWWWWWWWWWWWW