WWWWWWWWWWWWWWWW
WWWWWWWWWWWWWWWW
WWBBBBBFFFFFFFWW
WWBBBFFFFFFFFFWW
WDBBFFFFFFFFFFDW
WDFFFFFFFFFFFFDW
WDBBFFFFFFFFFFDW
WWBBBFFFFFFFFFWW
WWBBBBBFFFFFFFWW
WWWWWWWWWWWWWWWW
WWWWWWWWWWWWWWWW