WWWWWWWWWWWWWWWW
WWWWWWWWWWWWWWWW
WWFFFPFFFFFFFFWW
WWFFFPFFFFFFFFWW
WDFFFPFFFFFFFFWW
WDFFFPFFFFFFFFWW
WDFFFPFFFFFFFFWW
WWFFFPFFFFFFFFWW
WWFFFPFFFFFFFFWW
WWWWWWWDDWWWWWWW
WWWWWWWWWWWWWWWW