WWWWWWWWWWWWWWWW
WWWWWWWWWWWWWWWW
WWFFFFFFFFFFFFWW
WWFPPPPPPPPPPFWW
WDFPFFFFFFFFPFDW
WDFPFFFFFFFFPFDW
WDFPFFFFFFFFPFDW
WWFPPPPPPPPPPFWW
WWFFFFFFFFFFFFWW
WWWWWWWWWWWWWWWW
WWWWWWWWWWWWWWWW