WWWWWWWWWWWWWWWW
WWWWWWWWWWWWWWWW
WWFFFFFFFFFFFFWW
WWFFFFFFBFFFFFWW
WDFFFFFBFBFFFFWW
WDFFFFBFSFBFFFWW
WDFFFFFBFBFFFFWW
WWFFFFFFBFFFFFWW
WWFFFFFFFFFFFFWW
WWWWWWWDDWWWWWWW
WWWWWWWWWWWWWWWW