WWWWWWWWWWWWWWWW
WWWWWWWDDWWWWWWW
WWFFFFFFFFFFFFWW
WWFFFFFFBFFFFFWW
WDFFFFFBFBFFFFWW
WDFFFFBFSFBFFFWW
WDFFFFFBFBFFFFWW
WWFFFFFFBFFFFFWW
WWFFFFFFFFFFFFWW
WWWWWWWWWWWWWWWW
WWWWWWWWWWWWWWWW