WWWWWWWWWWWWWWWW
WWWWWWWWWWWWWWWW
WWFBFFFFFFFFFFWW
WWFBFBBBBBBBBFWW
WDFBFBSFFFFFBFWW
WDFBFBBBBFFFBFWW
WDFBFFFFFFFFBFWW
WWFBBBBBBBBBBFWW
WWFFFFFFFFFFFFWW
WWWWWWWWWWWWWWWW
WWWWWWWWWWWWWWWW