WWWWWWWWWWWWWWWW
WWWWWWWWWWWWWWWW
WWFFFFFFFFFFBFWW
WWFBBBBBBBBFBFWW
WWFBFFFFFSBFBFDW
WWFBFFFBBBBFBFDW
WWFBFFFFFFFFBFDW
WWFBBBBBBBBBBFWW
WWFFFFFFFFFFFFWW
WWWWWWWWWWWWWWWW
WWWWWWWWWWWWWWWW