WWWWWWWWWWWWWWWW
WWWWWWWDDWWWWWWW
WWPPPPPFFPPPPPWW
WWPFFFPFFFFPFPWW
WWPFPFPFPPFPFPDW
WWFFPFPFFPFPFFDW
WWPFPFPPFPFPFPDW
WWPFPFFFFPFFFPWW
WWPPPPPFFPPPPPWW
WWWWWWWWWWWWWWWW
WWWWWWWWWWWWWWWW