WWWWWWWWWWWWWWWW
WWWWWWWWWWWWWWWW
WWFBFFFFFFFFFFWW
WWFBFBBBBBBBBFWW
WWFBFBSFFFFFBFWW
WWFBFBBBBFFFBFWW
WWFBFFFFFFFFBFWW
WWFBBBBBBBBBBFWW
WWFFFFFFFFFFFFWW
WWWWWWWDDWWWWWWW
WWWWWWWWWWWWWWWW