WWWWWWWWWWWWWWWW
WWWWWWWWWWWWWWWW
WWFFFFFFFFFFFFWW
WWFBBBBBBBBBBFWW
WDFBFFFFFFFFBFWW
WDFBFBBBBFFFBFWW
WDFBFBSFFFFFBFWW
WWFBFBBBBBBBBFWW
WWFBFFFFFFFFFFWW
WWWWWWWWWWWWWWWW
WWWWWWWWWWWWWWWW