WWWWWWWWWWWWWWWW
WWWWWWWDDWWWWWWW
WWPPPPPFFPPPPPWW
WWPFFFPFFFFPFPWW
WWPFPFPFPPFPFPWW
WWFFPFPFFPFPFFWW
WWPFPFPPFPFPFPWW
WWPFPFFFFPFFFPWW
WWPPPPPFFPPPPPWW
WWWWWWWWWWWWWWWW
WWWWWWWWWWWWWWWW