WWWWWWWWWWWWWWWW
WWWWWWWWWWWWWWWW
WWFFFFFFFFFFFFWW
WWFFIFFFFFFIFFWW
WWFFFFFFFFFFFFDW
WWFFFFFFFFFFFFDW
WWFFFFFFFFFFFFDW
WWFFIFFFFFFIFFWW
WWFFFFFFFFFFFFWW
WWWWWWWDDWWWWWWW
WWWWWWWWWWWWWWWW