WWWWWWWWWWWWWWWW
WWWWWWWDDWWWWWWW
WWFFFFFFFFFFFFWW
WWFFIFFFFFFIFFWW
WDFFFFFFFFFFFFWW
WDFFFFFFFFFFFFWW
WDFFFFFFFFFFFFWW
WWFFIFFFFFFIFFWW
WWFFFFFFFFFFFFWW
WWWWWWWWWWWWWWWW
WWWWWWWWWWWWWWWW