WWWWWWWWWWWWWWWW
WWWWWWWDDWWWWWWW
WWFFFFFFFFFFFFWW
WWFPPPPPPPPPPFWW
WWFPFFFFFFFFPFWW
WWFPFFFFFFFFPFWW
WWFPFFFFFFFFPFWW
WWFPPPPPPPPPPFWW
WWFFFFFFFFFFFFWW
WWWWWWWDDWWWWWWW
WWWWWWWWWWWWWWWW