WWWWWWWWWWWWWWWW
WWWWWWWDDWWWWWWW
WWFFFFFFFFPFFFWW
WWFFFFFFFFPFFFWW
WDFFFFFFFFPFFFDW
WDFFFFFFFFPFFFDW
WDFFFFFFFFPFFFDW
WWFFFFFFFFPFFFWW
WWFFFFFFFFPFFFWW
WWWWWWWDDWWWWWWW
WWWWWWWWWWWWWWWW