WWWWWWWWWWWWWWWW
WWWWWWWWWWWWWWWW
WWFFFFFFFFFFFFWW
WWFFIFFFFFFIFFWW
WDFFFFFFFFFFFFWW
WDFFFFFFFFFFFFWW
WDFFFFFFFFFFFFWW
WWFFIFFFFFFIFFWW
WWFFFFFFFFFFFFWW
WWWWWWWDDWWWWWWW
WWWWWWWWWWWWWWWW