WWWWWWWWWWWWWWWW
WWWWWWWDDWWWWWWW
WWFFFFFFFFPFFFWW
WWFFFFFFFFPFFFWW
WDFFFFFFFFPFFFWW
WDFFFFFFFFPFFFWW
WDFFFFFFFFPFFFWW
WWFFFFFFFFPFFFWW
WWFFFFFFFFPFFFWW
WWWWWWWWWWWWWWWW
WWWWWWWWWWWWWWWW