WWWWWWWWWWWWWWWW
WWWWWWWDDWWWWWWW
WWMFFFFFFFFFFMWW
WWFFFFFFFFFFFFWW
WWFFFFFFFFFFFFDW
WWFFFFFFFFFFFFDW
WWFFFFFFFFFFFFDW
WWFFFFFFFFFFFFWW
WWMFFFFFFFFFFMWW
WWWWWWWWWWWWWWWW
WWWWWWWWWWWWWWWW