WWWWWWWWWWWWWWWW
WWWWWWWWWWWWWWWW
WWMFFFFFFFFFFMWW
WWFFFFFFFFFFFFWW
WWFFFFFFFFFFFFDW
WWFFFFFFFFFFFFDW
WWFFFFFFFFFFFFDW
WWFFFFFFFFFFFFWW
WWMFFFFFFFFFFMWW
WWWWWWWDDWWWWWWW
WWWWWWWWWWWWWWWW