WWWWWWWWWWWWWWWW
WWWWWWWDDWWWWWWW
WWMFFFFFFFFFFMWW
WWFFFFFFFFFFFFWW
WDFFFFFFFFFFFFWW
WDFFFFFFFFFFFFWW
WDFFFFFFFFFFFFWW
WWFFFFFFFFFFFFWW
WWMFFFFFFFFFFMWW
WWWWWWWWWWWWWWWW
WWWWWWWWWWWWWWWW