WWWWWWWWWWWWWWWW
WWWWWWWWWWWWWWWW
WWMFFFFFFFFFFMWW
WWFFFBFFFFBFFFWW
WDFFFFFFFFFFFFWW
WDFBFFFFFFFFBFWW
WDFFFFFFFFFFFFWW
WWFFFFFFFFFFFFWW
WWFFFFFFFFFFFFWW
WWWWWWWWWWWWWWWW
WWWWWWWWWWWWWWWW