WWWWWWWWWWWWWWWW
WWWWWWWDDWWWWWWW
WWFPPFFFFFFPPFWW
WWFPPFFFFFFPPFWW
WDFPPFFFFFFPPFWW
WDFPFFFFFFFPPFWW
WDFPPPPPPPPPPFWW
WWFPPPPPPPPPPFWW
WWFPPFFFFFFFFFWW
WWWWWWWWWWWWWWWW
WWWWWWWWWWWWWWWW