WWWWWWWWWWWWWWWW
WWWWWWWWWWWWWWWW
WWFFFFFFFFFFFFWW
WWFFBFFFFFFBFFWW
WDFFFFFFFFFFFFDW
WDFFFFFFFFFFFFDW
WDBBFFFFFFFFBBDW
WWBBBBFFFFBBBBWW
WWBBBBBFFBBBBBWW
WWWWWWWWWWWWWWWW
WWWWWWWWWWWWWWWW