WWWWWWWWWWWWWWWW
WWWWWWWDDWWWWWWW
WWFIFIFFFFFFFFWW
WWFIFIIIFIIIFFWW
WDFIFFFIFFFIIIWW
WDFIFIFIFFFIFFWW
WDFIIIFIFFFIFFWW
WWFFFFFIFIFIFIWW
WWFFIFFFFIFFFIWW
WWWWWWWDDWWWWWWW
WWWWWWWWWWWWWWWW