WWWWWWWWWWWWWWWW
WWWWWWWDDWWWWWWW
WWPPPPPFFPPPPPWW
WWPFFFPPPPFFFPWW
WDPFPPPFFPPPFPWW
WDFFPFFFFFFPFFWW
WDPFPPPFFPPPFPWW
WWPFFFPPPPFFFPWW
WWPPPPPFFPPPPPWW
WWWWWWWWWWWWWWWW
WWWWWWWWWWWWWWWW