WWWWWWWWWWWWWWWW
WWWWWWWWWWWWWWWW
WWFFFFFFFFFFFFWW
WWFFIIIIIIIIFFWW
WDFFIFFFFFFIFFDW
WDFFIFFFFFFIFFDW
WDFFIFFFFFFIFFDW
WWFFIIIIIIIIFFWW
WWFFFFFFFFFFFFWW
WWWWWWWDDWWWWWWW
WWWWWWWWWWWWWWWW