WWWWWWWWWWWWWWWW
WWWWWWWDDWWWWWWW
WWBFFFFFFFFBFFWW
WWFBFFFFBFFFBFWW
WWFFBFFFFBFFFFWW
WWFFFBFFFFBFFFWW
WWFFFFBFFFFBFFWW
WWFBFFFBFFFFBFWW
WWFFBFFFFFFFFBWW
WWWWWWWWWWWWWWWW
WWWWWWWWWWWWWWWW