WWWWWWWWWWWWWWWW
WWWWWWWDDWWWWWWW
WWBBBBBFFBBBBBWW
WWBBBBBBFBBBBBWW
WDBBBBBBFBBBBBDW
WDFFFFFFBFFFFFDW
WDBBBBBBFBBBBBDW
WWBBBBBBFBBBBBWW
WWBBBBBFFBBBBBWW
WWWWWWWDDWWWWWWW
WWWWWWWWWWWWWWWW