WWWWWWWWWWWWWWWW
WWWWWWWWWWWWWWWW
WWFFBFFFFFFFFBWW
WWFBFFFBFFFFBFWW
WDFFFFBFFFFBFFDW
WDFFFBFFFFBFFFDW
WDFFBFFFFBFFFFDW
WWFBFFFFBFFFBFWW
WWBFFFFFFFFBFFWW
WWWWWWWWWWWWWWWW
WWWWWWWWWWWWWWWW