WWWWWWWWWWWWWWWW
WWWWWWWWWWWWWWWW
WWFFFFFFFFFFFFWW
WWFBBFFFFFFBBFWW
WWFFFFFFFFFFFFWW
WWFFFFFBBFFFFFWW
WWFFFFFFFFFFFFWW
WWFBBFFFFFFBBFWW
WWFFFFFFFFFFFFWW
WWWWWWWDDWWWWWWW
WWWWWWWWWWWWWWWW