WWWWWWWWWWWWWWWW
WWWWWWWWWWWWWWWW
WWFFFFFFFFPFFFWW
WWFFFFFFFFPFFFWW
WDFFFFFFFFPFFFDW
WDFFFFFFFFPFFFDW
WDFFFFFFFFPFFFDW
WWFFFFFFFFPFFFWW
WWFFFFFFFFPFFFWW
WWWWWWWWWWWWWWWW
WWWWWWWWWWWWWWWW