WWWWWWWWWWWWWWWW
WWWWWWWWWWWWWWWW
WWFFFFFFFFFFFFWW
WWFFFFFFFFFFFFWW
WDFFFFFFFFFFFFDW
WDFBFFFFFFFFBFDW
WDFFFFFFFFFFFFDW
WWFFFBFFFFBFFFWW
WWMFFFFFFFFFFMWW
WWWWWWWWWWWWWWWW
WWWWWWWWWWWWWWWW