WWWWWWWWWWWWWWWW
WWWWWWWDDWWWWWWW
WWFFBFFFFFFFFBWW
WWFBFFFBFFFFBFWW
WWFFFFBFFFFBFFWW
WWFFFBFFFFBFFFWW
WWFFBFFFFBFFFFWW
WWFBFFFFBFFFBFWW
WWBFFFFFFFFBFFWW
WWWWWWWWWWWWWWWW
WWWWWWWWWWWWWWWW