WWWWWWWWWWWWWWWW
WWWWWWWWWWWWWWWW
WWFFFFFFFFFFFFWW
WWFFFFFFBFFFFFWW
WWFFFFFBFBFFFFWW
WWFFFFBFSFBFFFWW
WWFFFFFBFBFFFFWW
WWFFFFFFBFFFFFWW
WWFFFFFFFFFFFFWW
WWWWWWWDDWWWWWWW
WWWWWWWWWWWWWWWW