WWWWWWWWWWWWWWWW
WWWWWWWWWWWWWWWW
WWMFFFFFFFFFFMWW
WWFFFFFFFFFFFFWW
WDFFFFFFFFFFFFDW
WDFFFFFFFFFFFFDW
WDFFFFFFFFFFFFDW
WWFFFFFFFFFFFFWW
WWMFFFFFFFFFFMWW
WWWWWWWDDWWWWWWW
WWWWWWWWWWWWWWWW