WWWWWWWWWWWWWWWW
WWWWWWWWWWWWWWWW
WWFFFFFFFFFFFFWW
WWFBBBBBBBBBBFWW
WDFBFFFFFFFFBFWW
WDFBFFFBBBBFBFWW
WDFBFFFFFSBFBFWW
WWFBBBBBBBBFBFWW
WWFFFFFFFFFFBFWW
WWWWWWWWWWWWWWWW
WWWWWWWWWWWWWWWW