WWWWWWWWWWWWWWWW
WWWWWWWWWWWWWWWW
WWFFFFFFFFFFFFWW
WWFBBBBBBBBBBFWW
WWFBFFFFFFFFBFDW
WWFBFBBBBFFFBFDW
WWFBFBSFFFFFBFDW
WWFBFBBBBBBBBFWW
WWFBFFFFFFFFFFWW
WWWWWWWWWWWWWWWW
WWWWWWWWWWWWWWWW