WWWWWWWWWWWWWWWW
WWWWWWWDDWWWWWWW
WWIFFFFFFFFIFFWW
WWFIFFFFIFFFIFWW
WDFFIFFFFIFFFFDW
WDFFFIFFFFIFFFDW
WDFFFFIFFFFIFFDW
WWFIFFFIFFFFIFWW
WWFFIFFFFFFFFIWW
WWWWWWWWWWWWWWWW
WWWWWWWWWWWWWWWW