WWWWWWWWWWWWWWWW
WWWWWWWDDWWWWWWW
WWMFFFFFFFFFFMWW
WWFFFFFFFFFFFFWW
WDFFFFFFFFFFFFDW
WDFFFFFFFFFFFFDW
WDFFFFFFFFFFFFDW
WWFFFFFFFFFFFFWW
WWMFFFFFFFFFFMWW
WWWWWWWWWWWWWWWW
WWWWWWWWWWWWWWWW