WWWWWWWWWWWWWWWW
WWWWWWWDDWWWWWWW
WWBBBBBFFBBBBBWW
WWBBBBFFFFBBBBWW
WWBBFFFFFFFFBBWW
WWFFFFFFFFFFFFWW
WWFFFFFFFFFFFFWW
WWFFBFFFFFFBFFWW
WWFFFFFFFFFFFFWW
WWWWWWWWWWWWWWWW
WWWWWWWWWWWWWWWW