WWWWWWWWWWWWWWWW
WWWWWWWWWWWWWWWW
WWFFFFFFFFFFFFWW
WWFFFFFBFFFFFFWW
WWFFFFBFBFFFFFDW
WWFFFBFSFBFFFFDW
WWFFFFBFBFFFFFDW
WWFFFFFBFFFFFFWW
WWFFFFFFFFFFFFWW
WWWWWWWWWWWWWWWW
WWWWWWWWWWWWWWWW