WWWWWWWWWWWWWWWW
WWWWWWWWWWWWWWWW
WWBBBBBFFFFFFFWW
WWBBBFFFFFFFFFWW
WWBBFFFFFFFFFFDW
WWFFFFFFFFFFFFDW
WWBBFFFFFFFFFFDW
WWBBBFFFFFFFFFWW
WWBBBBBFFFFFFFWW
WWWWWWWDDWWWWWWW
WWWWWWWWWWWWWWWW