WWWWWWWWWWWWWWWW
WWWWWWWDDWWWWWWW
WWFFFFFFFBBBBBWW
WWFFFFFFFFFBBBWW
WDFFFFFFFFFFBBWW
WDFFFFFFFFFFFFWW
WDFFFFFFFFFFBBWW
WWFFFFFFFFFBBBWW
WWFFFFFFFBBBBBWW
WWWWWWWWWWWWWWWW
WWWWWWWWWWWWWWWW