WWWWWWWWWWWWWWWW
WWWWWWWWWWWWWWWW
WWFBFBFFFFFFFFWW
WWFBFBBBFBBBFFWW
WDFBFFFBFFFBBBDW
WDFBFBFBFFFBFFDW
WDFBBBFBFFFBFFDW
WWFFFFFBFBFBFBWW
WWFFBFFFFBFFFBWW
WWWWWWWWWWWWWWWW
WWWWWWWWWWWWWWWW