WWWWWWWWWWWWWWWW
WWWWWWWDDWWWWWWW
WWBBBBBFFBBBBBWW
WWBBBBBBFBBBBBWW
WDBBBBBBFBBBBBWW
WDFFFFFFBFFFFFWW
WDBBBBBBFBBBBBWW
WWBBBBBBFBBBBBWW
WWBBBBBFFBBBBBWW
WWWWWWWWWWWWWWWW
WWWWWWWWWWWWWWWW