WWWWWWWWWWWWWWWW
WWWWWWWWWWWWWWWW
WWBFFFFFFFFBFFWW
WWFBFFFFBFFFBFWW
WDFFBFFFFBFFFFWW
WDFFFBFFFFBFFFWW
WDFFFFBFFFFBFFWW
WWFBFFFBFFFFBFWW
WWFFBFFFFFFFFBWW
WWWWWWWWWWWWWWWW
WWWWWWWWWWWWWWWW