WWWWWWWWWWWWWWWW
WWWWWWWDDWWWWWWW
WWPPPPPFFPPPPPWW
WWPFFFPPPPFFFPWW
WWPFPPPFFPPPFPWW
WWFFPFFFFFFPFFWW
WWPFPPPFFPPPFPWW
WWPFFFPPPPFFFPWW
WWPPPPPFFPPPPPWW
WWWWWWWDDWWWWWWW
WWWWWWWWWWWWWWWW