WWWWWWWWWWWWWWWW
WWWWWWWDDWWWWWWW
WWBBBBFFFFFFFFWW
WWBBBBFFFFFFFFWW
WWBBBFFFFFFFFFDW
WWSFFFFFFFFFFFDW
WWBBBFFFFFFFFFDW
WWBBBBFFFFFFFFWW
WWBBBBFFFFFFFFWW
WWWWWWWDDWWWWWWW
WWWWWWWWWWWWWWWW