WWWWWWWWWWWWWWWW
WWWWWWWDDWWWWWWW
WWFFFFFFFFFFFFWW
WWFPPPPPPPPPPFWW
WWFPFFFFFFFFPFDW
WWFPFFFFFFFFPFDW
WWFPFFFFFFFFPFDW
WWFPPPPPPPPPPFWW
WWFFFFFFFFFFFFWW
WWWWWWWWWWWWWWWW
WWWWWWWWWWWWWWWW