WWWWWWWWWWWWWWWW
WWWWWWWDDWWWWWWW
WWFFFFFFFFFFFFWW
WWFFFFFFBFFFFFWW
WWFFFFFBFBFFFFDW
WWFFFFBFSFBFFFDW
WWFFFFFBFBFFFFDW
WWFFFFFFBFFFFFWW
WWFFFFFFFFFFFFWW
WWWWWWWDDWWWWWWW
WWWWWWWWWWWWWWWW