WWWWWWWWWWWWWWWW
WWWWWWWWWWWWWWWW
WWFFFFFFFFFFFFWW
WWFPPPPPPPPPPFWW
WDFPFFFFFFFFPFWW
WDFPFFFFFFFFPFWW
WDFPFFFFFFFFPFWW
WWFPPPPPPPPPPFWW
WWFFFFFFFFFFFFWW
WWWWWWWDDWWWWWWW
WWWWWWWWWWWWWWWW