WWWWWWWWWWWWWWWW
WWWWWWWDDWWWWWWW
WWFPPPPFFPPPPFWW
WWFPPPPFFPPPPFWW
WDFPPFFFFFFPPFWW
WDFPPFFFFFFPPFWW
WDFPPPPPPPPPPFWW
WWFPPPPPPPPPPFWW
WWFFFFFFFFFFFFWW
WWWWWWWDDWWWWWWW
WWWWWWWWWWWWWWWW