WWWWWWWWWWWWWWWW
WWWWWWWDDWWWWWWW
WWFBFBFFFFFFFFWW
WWFBFBBBFBBBFFWW
WWFBFFFBFFFBBBWW
WWFBFBFBFFFBFFWW
WWFBBBFBFFFBFFWW
WWFFFFFBFBFBFBWW
WWFFBFFFFBFFFBWW
WWWWWWWDDWWWWWWW
WWWWWWWWWWWWWWWW