WWWWWWWWWWWWWWWW
WWWWWWWWWWWWWWWW
WWBBBBBFFBBBBBWW
WWBBBBBFBBBBBBWW
WDBBBBBFBBBBBBDW
WDFFFFFBFFFFFFDW
WDBBBBBFBBBBBBDW
WWBBBBBFBBBBBBWW
WWBBBBBFFBBBBBWW
WWWWWWWDDWWWWWWW
WWWWWWWWWWWWWWWW