WWWWWWWWWWWWWWWW
WWWWWWWWWWWWWWWW
WWFFFFFFFFBFBFWW
WWFFBBBFBBBFBFWW
WDBBBFFFBFFFBFWW
WDFFBFFFBFBFBFWW
WDFFBFFFBFBBBFWW
WWBFBFBFBFFFFFWW
WWBFFFBFFFFBFFWW
WWWWWWWDDWWWWWWW
WWWWWWWWWWWWWWWW