WWWWWWWWWWWWWWWW
WWWWWWWDDWWWWWWW
WWIIIIIFFIIIIIWW
WWIIIIIFIIIIIIWW
WDIIIIIFIIIIIIDW
WDFFFFFIFFFFFFDW
WDIIIIIFIIIIIIDW
WWIIIIIFIIIIIIWW
WWIIIIIFFIIIIIWW
WWWWWWWDDWWWWWWW
WWWWWWWWWWWWWWWW