WWWWWWWWWWWWWWWW
WWWWWWWDDWWWWWWW
WWBFFFBFFFFBFFWW
WWBFBFBFBFFFFFWW
WDFFBFFFBFBBBFWW
WDFFBFFFBFBFBFWW
WDBBBFFFBFFFBFWW
WWFFBBBFBBBFBFWW
WWFFFFFFFFBFBFWW
WWWWWWWWWWWWWWWW
WWWWWWWWWWWWWWWW