WWWWWWWWWWWWWWWW
WWWWWWWWWWWWWWWW
WWFFFFFFFBBBBBWW
WWFFFFFFFBBBBBWW
WWFFFFFFFBBBBBWW
WWFFFFFFFFFBBBWW
WWFFFFFFFFFFBBDW
WWFFFFFFFFFFFFDW
WWFFFFFFFFFFBBDW
WWFFFFFFFFFBBBWW
WWFFFFFFFBBBBBWW
WWFFFFFFFBBBBBWW
WWFFFFFFFBBBBBWW
WWWWWWWDDWWWWWWW
WWWWWWWWWWWWWWWW