WWWWWWWWWWWWWWWW
WWWWWWWWWWWWWWWW
WWFFFFFFFFFFFFWW
WWFFFFFFFFFFFFWW
WWFFFFFFFFFFFFWW
WWFBBBBFFBBBBFWW
WDFBFFFFFFFFBFWW
WDFBFMFFFFMFBFWW
WDFBFFMFFMFFBFWW
WWFBBBBBBBBBBFWW
WWFFFFFFFFFFFFWW
WWFFFFFFFFFFFFWW
WWFFFFFFFFFFFFWW
WWWWWWWWWWWWWWWW
WWWWWWWWWWWWWWWW