WWWWWWWWWWWWWWWW
WWWWWWWDDWWWWWWW
WWPPPPPFFPPPPPWW
WWPPPPPFFPPPPPWW
WWPPPPPFFPPPPPWW
WWPFPFFFFPFFFPWW
WWPFPFPPFPFPFPWW
WWFFPFPFFPFPFFWW
WWPFPFPFPPFPFPWW
WWPFFFPFFFFPFPWW
WWPPPPPFFPPPPPWW
WWPPPPPFFPPPPPWW
WWPPPPPFFPPPPPWW
WWWWWWWDDWWWWWWW
WWWWWWWWWWWWWWWW