WWWWWWWWWWWWWWWW
WWWWWWWDDWWWWWWW
WWFFFOOOOOOFFFWW
WWFFFOOOOOOFFFWW
WWFFFOOOOOOFFFWW
WWFMFOMOOMOFMFWW
WDFFFFFOOFFFFFDW
WDFMFFMFFMFFMFDW
WDFFFFFFFFFFFFDW
WWFMFFMFFMFFMFWW
WWFFFFFFFFFFFFWW
WWFFFFFFFFFFFFWW
WWFFFFFFFFFFFFWW
WWWWWWWDDWWWWWWW
WWWWWWWWWWWWWWWW