WWWWWWWWWWWWWWWW
WWWWWWWWWWWWWWWW
WWOOOOOOOOOOOOWW
WWOOOOOOOOOOOOWW
WWOOOOOOOOOOOOWW
WWOOOOOOOOOOOOWW
WWOOOOOOOOOOOODW
WWOOOOOOOOOOOODW
WWOOOOOOOOOOOODW
WWOOOOOOOOOOOOWW
WWOOOOOOOOOOOOWW
WWOOOOOOOOOOOOWW
WWOOOOOOOOOOOOWW
WWWWWWWDDWWWWWWW
WWWWWWWWWWWWWWWW