WWWWWWWWWWWWWWWW
WWWWWWWDDWWWWWWW
WWFFFOOOOOOFFFWW
WWFFFOOOOOOFFFWW
WWFFFOOOOOOFFFWW
WWFMFOMOOMOFMFWW
WWFFFFFOOFFFFFDW
WWFMFFMFFMFFMFDW
WWFFFFFFFFFFFFDW
WWFMFFMFFMFFMFWW
WWFFFFFFFFFFFFWW
WWFFFFFFFFFFFFWW
WWFFFFFFFFFFFFWW
WWWWWWWDDWWWWWWW
WWWWWWWWWWWWWWWW