WWWWWWWWWWWWWWWW
WWWWWWWDDWWWWWWW
WWFFFOOOOOOFFFWW
WWFFFOOOOOOFFFWW
WWFFFOOOOOOFFFWW
WWFMFOMOOMOFMFWW
WDFFFFFOOFFFFFWW
WDFMFFMFFMFFMFWW
WDFFFFFFFFFFFFWW
WWFMFFMFFMFFMFWW
WWFFFFFFFFFFFFWW
WWFFFFFFFFFFFFWW
WWFFFFFFFFFFFFWW
WWWWWWWDDWWWWWWW
WWWWWWWWWWWWWWWW