WWWWWWWWWWWWWWWW
WWWWWWWWWWWWWWWW
WWFFFFFFFFBBBBWW
WWFFFFFFFFBBBBWW
WWFFFFFFFFBBBBWW
WWFFFFFFFFBBBBWW
WDFFFFFFFFFBBBWW
WDFFFFFFFFFFFSWW
WDFFFFFFFFFBBBWW
WWFFFFFFFFBBBBWW
WWFFFFFFFFBBBBWW
WWFFFFFFFFBBBBWW
WWFFFFFFFFBBBBWW
WWWWWWWWWWWWWWWW
WWWWWWWWWWWWWWWW