WWWWWWWWWWWWWWWW
WWWWWWWWWWWWWWWW
WWBBBBFFFFFFFFWW
WWBBBBFFFFFFFFWW
WWBBBBFFFFFFFFWW
WWBBBBFFFFFFFFWW
WWBBBFFFFFFFFFDW
WWSFFFFFFFFFFFDW
WWBBBFFFFFFFFFDW
WWBBBBFFFFFFFFWW
WWBBBBFFFFFFFFWW
WWBBBBFFFFFFFFWW
WWBBBBFFFFFFFFWW
WWWWWWWWWWWWWWWW
WWWWWWWWWWWWWWWW