WWWWWWWWWWWWWWWW
WWWWWWWDDWWWWWWW
WWOOOOOOOOOOOOWW
WWOOOOOOOOOOOOWW
WWOOOOOOOOOOOOWW
WWOOOOOOOOOOOOWW
WWOOOOOOOOOOOODW
WWOOOOOOOOOOOODW
WWOOOOOOOOOOOODW
WWOOOOOOOOOOOOWW
WWOOOOOOOOOOOOWW
WWOOOOOOOOOOOOWW
WWOOOOOOOOOOOOWW
WWWWWWWWWWWWWWWW
WWWWWWWWWWWWWWWW