WWWWWWWWWWWWWWWW
WWWWWWWDDWWWWWWW
WWFFFFFFFFFFFFWW
WWFFFFFFFFFFFFWW
WWFFFFFFFFFFFFWW
WWFMFFMFFMFFMFWW
WDFFFFFFFFFFFFWW
WDFMFFMFFMFFMFWW
WDFFFFFOOFFFFFWW
WWFMFOMOOMOFMFWW
WWFFFOOOOOOFFFWW
WWFFFOOOOOOFFFWW
WWFFFOOOOOOFFFWW
WWWWWWWDDWWWWWWW
WWWWWWWWWWWWWWWW