WWWWWWWWWWWWWWWW
WWWWWWWDDWWWWWWW
WWBBBBFFFFFFFFWW
WWBBBBFFFFFFFFWW
WWBBBBFFFFFFFFWW
WWBBBBFFFFFFFFWW
WWBBBFFFFFFFFFWW
WWSFFFFFFFFFFFWW
WWBBBFFFFFFFFFWW
WWBBBBFFFFFFFFWW
WWBBBBFFFFFFFFWW
WWBBBBFFFFFFFFWW
WWBBBBFFFFFFFFWW
WWWWWWWWWWWWWWWW
WWWWWWWWWWWWWWWW