WWWWWWWWWWWWWWWW
WWWWWWWWWWWWWWWW
WWFFFFFFFFFFFFWW
WWFFFFFFFFFFFFWW
WWFFFFFFFFFFFFWW
WWFBBBBBBBBBBFWW
WWFBFFFFFFFFBFWW
WWFBFFFBBBBFBFWW
WWFBFFFFFSBFBFWW
WWFBBBBBBBBFBFWW
WWFFFFFFFFFFBFWW
WWFFFFFFFFFFBFWW
WWFFFFFFFFFFBFWW
WWWWWWWWWWWWWWWW
WWWWWWWWWWWWWWWW