WWWWWWWWWWWWWWWW
WWWWWWWDDWWWWWWW
WWFFFFFFFFFFFFWW
WWFFFFFFFFFFFFWW
WWFFFFFFFFFFFFWW
WWFMFFMFFMFFMFWW
WWFFFFFFFFFFFFWW
WWFMFFMFFMFFMFWW
WWFFFFFOOFFFFFWW
WWFMFOMOOMOFMFWW
WWFFFOOOOOOFFFWW
WWFFFOOOOOOFFFWW
WWFFFOOOOOOFFFWW
WWWWWWWDDWWWWWWW
WWWWWWWWWWWWWWWW