WWWWWWWWWWWWWWWW
WWWWWWWWWWWWWWWW
WWFFFFBFFBFFFFWW
WWFFFFBFFBFFFFWW
WWFFFFBFFBFFFFWW
WWFFFFBFFBFFFFWW
WWFFFFBFFBFFFFWW
WWFFFFBFFBFFFFWW
WWFFFFBFFBFFFFWW
WWFFFFBFFBFFFFWW
WWFFFFBFFBFFFFWW
WWFFFFBFFBFFFFWW
WWFFFFBFFBFFFFWW
WWWWWWWDDWWWWWWW
WWWWWWWWWWWWWWWW