WWWWWWWWWWWWWWWW
WWWWWWWDDWWWWWWW
WWBBBBBFFBBBBBWW
WWBBBBBFFBBBBBWW
WWBBBBBFFBBBBBWW
WWBBBBFFFFBBBBWW
WWBBFFFFFFFFBBDW
WWFFFFFFFFFFFFDW
WWFFFFFFFFFFFFDW
WWFFBFFFFFFBFFWW
WWFFFFFFFFFFFFWW
WWFFFFFFFFFFFFWW
WWFFFFFFFFFFFFWW
WWWWWWWWWWWWWWWW
WWWWWWWWWWWWWWWW