WWWWWWWWWWWWWWWW
WWWWWWWDDWWWWWWW
WWMFFFFFFFFFFMWW
WWMFFFFFFFFFFMWW
WWMFFFFFFFFFFMWW
WWFFFBFFFFBFFFWW
WWFFFFFFFFFFFFWW
WWFBFFFFFFFFBFWW
WWFFFFFFFFFFFFWW
WWFFFFFFFFFFFFWW
WWFFFFFFFFFFFFWW
WWFFFFFFFFFFFFWW
WWFFFFFFFFFFFFWW
WWWWWWWDDWWWWWWW
WWWWWWWWWWWWWWWW