WWWWWWWWWWWWWWWW
WWWWWWWWWWWWWWWW
WWIFFFIFFFFIFFWW
WWIFFFIFFFFIFFWW
WWIFFFIFFFFIFFWW
WWIFIFIFIFFFFFWW
WWFFIFFFIFIIIFDW
WWFFIFFFIFIFIFDW
WWIIIFFFIFFFIFDW
WWFFIIIFIIIFIFWW
WWFFFFFFFFIFIFWW
WWFFFFFFFFIFIFWW
WWFFFFFFFFIFIFWW
WWWWWWWWWWWWWWWW
WWWWWWWWWWWWWWWW