WWWWWWWWWWWWWWWW
WWWWWWWDDWWWWWWW
WWPPPPPFFPPPPPWW
WWPPPPPFFPPPPPWW
WWPPPPPFFPPPPPWW
WWPFPFFFFPFFFPWW
WDPFPFPPFPFPFPDW
WDFFPFPFFPFPFFDW
WDPFPFPFPPFPFPDW
WWPFFFPFFFFPFPWW
WWPPPPPFFPPPPPWW
WWPPPPPFFPPPPPWW
WWPPPPPFFPPPPPWW
WWWWWWWWWWWWWWWW
WWWWWWWWWWWWWWWW