WWWWWWWWWWWWWWWW
WWWWWWWWWWWWWWWW
WWFFIFFFFIFFFIWW
WWFFIFFFFIFFFIWW
WWFFIFFFFIFFFIWW
WWFFFFFIFIFIFIWW
WDFIIIFIFFFIFFWW
WDFIFIFIFFFIFFWW
WDFIFFFIFFFIIIWW
WWFIFIIIFIIIFFWW
WWFIFIFFFFFFFFWW
WWFIFIFFFFFFFFWW
WWFIFIFFFFFFFFWW
WWWWWWWWWWWWWWWW
WWWWWWWWWWWWWWWW