WWWWWWWWWWWWWWWW
WWWWWWWDDWWWWWWW
WWFFFFFFFFFFFFWW
WWFFFFFFFFFFFFWW
WWFFFFFFFFFFFFWW
WWFPPPFFFFPPPFWW
WWFPFFFFFFFFPFWW
WWFPFPPPPPPFPFWW
WWFPFFFFFFFFPFWW
WWFPPPFFFFPPPFWW
WWFFFFFFFFFFFFWW
WWFFFFFFFFFFFFWW
WWFFFFFFFFFFFFWW
WWWWWWWDDWWWWWWW
WWWWWWWWWWWWWWWW