WWWWWWWWWWWWWWWW
WWWWWWWDDWWWWWWW
WWFFFFFFFFFFFFWW
WWFFFFFFFFFFFFWW
WWFFFFFFFFFFFFWW
WWFFFFFFFFFFFFWW
WWFFFFFFFFFFFFWW
WWFBFFFFFFFFBFWW
WWFFFFFFFFFFFFWW
WWFFFBFFFFBFFFWW
WWMFFFFFFFFFFMWW
WWMFFFFFFFFFFMWW
WWMFFFFFFFFFFMWW
WWWWWWWDDWWWWWWW
WWWWWWWWWWWWWWWW