WWWWWWWWWWWWWWWW
WWWWWWWDDWWWWWWW
WWIFFFFFFFFIFFWW
WWIFFFFFFFFIFFWW
WWIFFFFFFFFIFFWW
WWFIFFFFIFFFIFWW
WDFFIFFFFIFFFFWW
WDFFFIFFFFIFFFWW
WDFFFFIFFFFIFFWW
WWFIFFFIFFFFIFWW
WWFFIFFFFFFFFIWW
WWFFIFFFFFFFFIWW
WWFFIFFFFFFFFIWW
WWWWWWWWWWWWWWWW
WWWWWWWWWWWWWWWW