WWWWWWWWWWWWWWWW
WWWWWWWWWWWWWWWW
WWIFFFFFFFFIFFWW
WWIFFFFFFFFIFFWW
WWIFFFFFFFFIFFWW
WWFIFFFFIFFFIFWW
WWFFIFFFFIFFFFDW
WWFFFIFFFFIFFFDW
WWFFFFIFFFFIFFDW
WWFIFFFIFFFFIFWW
WWFFIFFFFFFFFIWW
WWFFIFFFFFFFFIWW
WWFFIFFFFFFFFIWW
WWWWWWWWWWWWWWWW
WWWWWWWWWWWWWWWW