WWWWWWWWWWWWWWWW
WWWWWWWDDWWWWWWW
WWFFFPFFFFFFFFWW
WWFFFPFFFFFFFFWW
WWFFFPFFFFFFFFWW
WWFFFPFFFFFFFFWW
WWFFFPFFFFFFFFWW
WWFFFPFFFFFFFFWW
WWFFFPFFFFFFFFWW
WWFFFPFFFFFFFFWW
WWFFFPFFFFFFFFWW
WWFFFPFFFFFFFFWW
WWFFFPFFFFFFFFWW
WWWWWWWWWWWWWWWW
WWWWWWWWWWWWWWWW