WWWWWWWWWWWWWWWW
WWWWWWWDDWWWWWWW
WWFFFFFFFFFFFFWW
WWFFFFFFFFFFFFWW
WWFFFFFFFFFFFFWW
WWFFFFFFFFFFFFWW
WWFFFFFFFFFFFFDW
WWFBFFFFFFFFBFDW
WWFFFFFFFFFFFFDW
WWFFFBFFFFBFFFWW
WWMFFFFFFFFFFMWW
WWMFFFFFFFFFFMWW
WWMFFFFFFFFFFMWW
WWWWWWWDDWWWWWWW
WWWWWWWWWWWWWWWW