WWWWWWWWWWWWWWWW
WWWWWWWWWWWWWWWW
WWFBFBFFFFFFFFWW
WWFBFBFFFFFFFFWW
WWFBFBFFFFFFFFWW
WWFBFBBBFBBBFFWW
WDFBFFFBFFFBBBWW
WDFBFBFBFFFBFFWW
WDFBBBFBFFFBFFWW
WWFFFFFBFBFBFBWW
WWFFBFFFFBFFFBWW
WWFFBFFFFBFFFBWW
WWFFBFFFFBFFFBWW
WWWWWWWDDWWWWWWW
WWWWWWWWWWWWWWWW