WWWWWWWWWWWWWWWW
WWWWWWWWWWWWWWWW
WWFFFFFFFFBFBFWW
WWFFFFFFFFBFBFWW
WWFFFFFFFFBFBFWW
WWFFBBBFBBBFBFWW
WWBBBFFFBFFFBFDW
WWFFBFFFBFBFBFDW
WWFFBFFFBFBBBFDW
WWBFBFBFBFFFFFWW
WWBFFFBFFFFBFFWW
WWBFFFBFFFFBFFWW
WWBFFFBFFFFBFFWW
WWWWWWWDDWWWWWWW
WWWWWWWWWWWWWWWW