WWWWWWWWWWWWWWWW
WWWWWWWWWWWWWWWW
WWFFFFFFFFPFFFWW
WWFFFFFFFFPFFFWW
WWFFFFFFFFPFFFWW
WWFFFFFFFFPFFFWW
WWFFFFFFFFPFFFWW
WWFFFFFFFFPFFFWW
WWFFFFFFFFPFFFWW
WWFFFFFFFFPFFFWW
WWFFFFFFFFPFFFWW
WWFFFFFFFFPFFFWW
WWFFFFFFFFPFFFWW
WWWWWWWDDWWWWWWW
WWWWWWWWWWWWWWWW