WWWWWWWWWWWWWWWW
WWWWWWWDDWWWWWWW
WWFFFFFFFFFFFFWW
WWFFFFFFFFFFFFWW
WWFFFFFFFFFFFFWW
WWFIIFFFFFFIIFWW
WDFFFFFFFFFFFFWW
WDFFFFFIIFFFFFWW
WDFFFFFFFFFFFFWW
WWFIIFFFFFFIIFWW
WWFFFFFFFFFFFFWW
WWFFFFFFFFFFFFWW
WWFFFFFFFFFFFFWW
WWWWWWWDDWWWWWWW
WWWWWWWWWWWWWWWW