WWWWWWWWWWWWWWWW
WWWWWWWWWWWWWWWW
WWFFFFFFFFFFFFWW
WWFFFFFFFFFFFFWW
WWFFFFFFFFFFFFWW
WWFPPPFFFFPPPFWW
WWFPFFFFFFFFPFWW
WWFPFPPPPPPFPFWW
WWFPFFFFFFFFPFWW
WWFPPPFFFFPPPFWW
WWFFFFFFFFFFFFWW
WWFFFFFFFFFFFFWW
WWFFFFFFFFFFFFWW
WWWWWWWWWWWWWWWW
WWWWWWWWWWWWWWWW