WWWWWWWWWWWWWWWW
WWWWWWWDDWWWWWWW
WWBBBBBFFBBBBBWW
WWBBBBBFFBBBBBWW
WWBBBBBFFBBBBBWW
WWBBBBBFBBBBBBWW
WWBBBBBFBBBBBBDW
WWFFFFFBFFFFFFDW
WWBBBBBFBBBBBBDW
WWBBBBBFBBBBBBWW
WWBBBBBFFBBBBBWW
WWBBBBBFFBBBBBWW
WWBBBBBFFBBBBBWW
WWWWWWWDDWWWWWWW
WWWWWWWWWWWWWWWW