WWWWWWWWWWWWWWWW
WWWWWWWDDWWWWWWW
WWFFBFFFFBFFFBWW
WWFFBFFFFBFFFBWW
WWFFBFFFFBFFFBWW
WWFFFFFBFBFBFBWW
WDFBBBFBFFFBFFWW
WDFBFBFBFFFBFFWW
WDFBFFFBFFFBBBWW
WWFBFBBBFBBBFFWW
WWFBFBFFFFFFFFWW
WWFBFBFFFFFFFFWW
WWFBFBFFFFFFFFWW
WWWWWWWWWWWWWWWW
WWWWWWWWWWWWWWWW