WWWWWWWWWWWWWWWW
WWWWWWWWWWWWWWWW
WWFFFFFFFFPFFFWW
WWFFFFFFFFPFFFWW
WWFFFFFFFFPFFFWW
WWFFFFFFFFPFFFWW
WWFFFFFFFFPFFFDW
WWFFFFFFFFPFFFDW
WWFFFFFFFFPFFFDW
WWFFFFFFFFPFFFWW
WWFFFFFFFFPFFFWW
WWFFFFFFFFPFFFWW
WWFFFFFFFFPFFFWW
WWWWWWWDDWWWWWWW
WWWWWWWWWWWWWWWW