WWWWWWWWWWWWWWWW
WWWWWWWDDWWWWWWW
WWMFFFFFFFFFFMWW
WWMFFFFFFFFFFMWW
WWMFFFFFFFFFFMWW
WWFFFFFFFFFFFFWW
WDFFFFFFFFFFFFWW
WDFFFFFFFFFFFFWW
WDFFFFFFFFFFFFWW
WWFFFFFFFFFFFFWW
WWMFFFFFFFFFFMWW
WWMFFFFFFFFFFMWW
WWMFFFFFFFFFFMWW
WWWWWWWDDWWWWWWW
WWWWWWWWWWWWWWWW