WWWWWWWWWWWWWWWW
WWWWWWWDDWWWWWWW
WWPPPPPFFPPPPPWW
WWPPPPPFFPPPPPWW
WWPPPPPFFPPPPPWW
WWPFPFFFFPFFFPWW
WDPFPFPPFPFPFPWW
WDFFPFPFFPFPFFWW
WDPFPFPFPPFPFPWW
WWPFFFPFFFFPFPWW
WWPPPPPFFPPPPPWW
WWPPPPPFFPPPPPWW
WWPPPPPFFPPPPPWW
WWWWWWWWWWWWWWWW
WWWWWWWWWWWWWWWW