WWWWWWWWWWWWWWWW
WWWWWWWWWWWWWWWW
WWPPPPPPPPPPPPWW
WWPPPPPPPPPPPPWW
WWPPPPPPPPPPPPWW
WWPPPPPPPPPPPPWW
WDPPPPPPPPPPPPWW
WDPPPPPPPPPPPPWW
WDPPPPPPPPPPPPWW
WWPPPPPPPPPPPPWW
WWPPPPPPPPPPPPWW
WWPPPPPPPPPPPPWW
WWPPPPPPPPPPPPWW
WWWWWWWDDWWWWWWW
WWWWWWWWWWWWWWWW