WWWWWWWWWWWWWWWW
WWWWWWWWWWWWWWWW
WWFFFFFFFFFFFFWW
WWFFFFFFFFFFFFWW
WWFFFFFFFFFFFFWW
WWFFFFFFFFFFFFWW
WDFFFFFFFFFFFFWW
WDFBFFFFFFFFBFWW
WDFFFFFFFFFFFFWW
WWFFFBFFFFBFFFWW
WWMFFFFFFFFFFMWW
WWMFFFFFFFFFFMWW
WWMFFFFFFFFFFMWW
WWWWWWWDDWWWWWWW
WWWWWWWWWWWWWWWW