WWWWWWWWWWWWWWWW
WWWWWWWDDWWWWWWW
WWMFFFFFFFFFFMWW
WWMFFFFFFFFFFMWW
WWMFFFFFFFFFFMWW
WWFFFBFFFFBFFFWW
WWFFFFFFFFFFFFDW
WWFBFFFFFFFFBFDW
WWFFFFFFFFFFFFDW
WWFFFFFFFFFFFFWW
WWFFFFFFFFFFFFWW
WWFFFFFFFFFFFFWW
WWFFFFFFFFFFFFWW
WWWWWWWWWWWWWWWW
WWWWWWWWWWWWWWWW