WWWWWWWWWWWWWWWW
WWWWWWWDDWWWWWWW
WWFFFFFFFFFFFFWW
WWFFFFFFFFFFFFWW
WWFFFFFFFFFFFFWW
WWFBBBBBBBBBBFWW
WWFBFFFFFFFFBFWW
WWFBFBBBBFFFBFWW
WWFBFBSFFFFFBFWW
WWFBFBBBBBBBBFWW
WWFBFFFFFFFFFFWW
WWFBFFFFFFFFFFWW
WWFBFFFFFFFFFFWW
WWWWWWWWWWWWWWWW
WWWWWWWWWWWWWWWW