WWWWWWWWWWWWWWWW
WWWWWWWWWWWWWWWW
WWPPPPPPPPPPPPWW
WWPPPPPPPPPPPPWW
WWPPPPPPPPPPPPWW
WWPPPPPPPPPPPPWW
WWPPPPPPPPPPPPDW
WWPPPPPPPPPPPPDW
WWPPPPPPPPPPPPDW
WWPPPPPPPPPPPPWW
WWPPPPPPPPPPPPWW
WWPPPPPPPPPPPPWW
WWPPPPPPPPPPPPWW
WWWWWWWDDWWWWWWW
WWWWWWWWWWWWWWWW