WWWWWWWWWWWWWWWW
WWWWWWWWWWWWWWWW
WWPPPPPFFPPPPPWW
WWPPPPPFFPPPPPWW
WWPPPPPFFPPPPPWW
WWPFFFPFFFFPFPWW
WWPFPFPFPPFPFPWW
WWFFPFPFFPFPFFWW
WWPFPFPPFPFPFPWW
WWPFPFFFFPFFFPWW
WWPPPPPFFPPPPPWW
WWPPPPPFFPPPPPWW
WWPPPPPFFPPPPPWW
WWWWWWWDDWWWWWWW
WWWWWWWWWWWWWWWW