WWWWWWWWWWWWWWWW
WWWWWWWWWWWWWWWW
WWFFFFFFFFFFFFWW
WWFFFFFFFFFFFFWW
WWFFFFFFFFFFFFWW
WWFFFFFFFFFFFFWW
WWFFFFFFFFFFFFDW
WWFFFFFFBFFFFFDW
WWFFFFFFFFFFFFDW
WWFFFFFFFFFFFFWW
WWFFFFFFFFFFFFWW
WWFFFFFFFFFFFFWW
WWFFFFFFFFFFFFWW
WWWWWWWWWWWWWWWW
WWWWWWWWWWWWWWWW