WWWWWWWWWWWWWWWW
WWWWWWWWWWWWWWWW
WWFFFPFFFFFFFFWW
WWFFFPFFFFFFFFWW
WWFFFPFFFFFFFFWW
WWFFFPFFFFFFFFWW
WWFFFPFFFFFFFFDW
WWFFFPFFFFFFFFDW
WWFFFPFFFFFFFFDW
WWFFFPFFFFFFFFWW
WWFFFPFFFFFFFFWW
WWFFFPFFFFFFFFWW
WWFFFPFFFFFFFFWW
WWWWWWWDDWWWWWWW
WWWWWWWWWWWWWWWW