WWWWWWWWWWWWWWWW
WWWWWWWDDWWWWWWW
WWFFFPFFFFFFFFWW
WWFFFPFFFFFFFFWW
WWFFFPFFFFFFFFWW
WWFFFPFFFFFFFFWW
WDFFFPFFFFFFFFDW
WDFFFPFFFFFFFFDW
WDFFFPFFFFFFFFDW
WWFFFPFFFFFFFFWW
WWFFFPFFFFFFFFWW
WWFFFPFFFFFFFFWW
WWFFFPFFFFFFFFWW
WWWWWWWDDWWWWWWW
WWWWWWWWWWWWWWWW