WWWWWWWWWWWWWWWW
WWWWWWWDDWWWWWWW
WWFFFFFFFFFFFFWW
WWFFFFFFFFFFFFWW
WWFFFFFFFFFFFFWW
WWFFBFFFFFFBFFWW
WWFFFFFFFFFFFFDW
WWFFFFFFFFFFFFDW
WWBBFFFFFFFFBBDW
WWBBBBFFFFBBBBWW
WWBBBBBFFBBBBBWW
WWBBBBBFFBBBBBWW
WWBBBBBFFBBBBBWW
WWWWWWWWWWWWWWWW
WWWWWWWWWWWWWWWW