WWWWWWWWWWWWWWWW
WWWWWWWDDWWWWWWW
WWFFIFFFFIFFFIWW
WWFFIFFFFIFFFIWW
WWFFIFFFFIFFFIWW
WWFFFFFIFIFIFIWW
WDFIIIFIFFFIFFWW
WDFIFIFIFFFIFFWW
WDFIFFFIFFFIIIWW
WWFIFIIIFIIIFFWW
WWFIFIFFFFFFFFWW
WWFIFIFFFFFFFFWW
WWFIFIFFFFFFFFWW
WWWWWWWDDWWWWWWW
WWWWWWWWWWWWWWWW