WWWWWWWWWWWWWWWW
WWWWWWWWWWWWWWWW
WWFPPFFFFFFFFFWW
WWFPPFFFFFFFFFWW
WWFPPFFFFFFFFFWW
WWFPPPPPPPPPPFWW
WDFPPPPPPPPPPFWW
WDFPFFFFFFFPPFWW
WDFPPFFFFFFPPFWW
WWFPPFFFFFFPPFWW
WWFPPFFFFFFPPFWW
WWFPPFFFFFFPPFWW
WWFPPFFFFFFPPFWW
WWWWWWWDDWWWWWWW
WWWWWWWWWWWWWWWW