WWWWWWWWWWWWWWWW
WWWWWWWWWWWWWWWW
WWPPPPPFFPPPPPWW
WWPPPPPFFPPPPPWW
WWPPPPPFFPPPPPWW
WWPFFFPPPPFFFPWW
WWPFPPPFFPPPFPDW
WWFFPFFFFFFPFFDW
WWPFPPPFFPPPFPDW
WWPFFFPPPPFFFPWW
WWPPPPPFFPPPPPWW
WWPPPPPFFPPPPPWW
WWPPPPPFFPPPPPWW
WWWWWWWDDWWWWWWW
WWWWWWWWWWWWWWWW