WWWWWWWWWWWWWWWW
WWWWWWWWWWWWWWWW
WWFFFFFFFFFFFFWW
WWFFFFFFFFFFFFWW
WWFFFFFFFFFFFFWW
WWFPPPFFFFPPPFWW
WDFPFFFFFFFFPFDW
WDFPFPPPPPPFPFDW
WDFPFFFFFFFFPFDW
WWFPPPFFFFPPPFWW
WWFFFFFFFFFFFFWW
WWFFFFFFFFFFFFWW
WWFFFFFFFFFFFFWW
WWWWWWWDDWWWWWWW
WWWWWWWWWWWWWWWW