WWWWWWWWWWWWWWWW
WWWWWWWDDWWWWWWW
WWPPPPPPPPPPPPWW
WWPPPPPPPPPPPPWW
WWPPPPPPPPPPPPWW
WWPPPPPPPPPPPPWW
WWPPPPPPPPPPPPWW
WWPPPPPPPPPPPPWW
WWPPPPPPPPPPPPWW
WWPPPPPPPPPPPPWW
WWPPPPPPPPPPPPWW
WWPPPPPPPPPPPPWW
WWPPPPPPPPPPPPWW
WWWWWWWWWWWWWWWW
WWWWWWWWWWWWWWWW