WWWWWWWWWWWWWWWW
WWWWWWWWWWWWWWWW
WWMFFFFFFFFFFMWW
WWMFFFFFFFFFFMWW
WWMFFFFFFFFFFMWW
WWFFFFFFFFFFFFWW
WDFFFFFFFFFFFFDW
WDFFFFFFFFFFFFDW
WDFFFFFFFFFFFFDW
WWFFFFFFFFFFFFWW
WWMFFFFFFFFFFMWW
WWMFFFFFFFFFFMWW
WWMFFFFFFFFFFMWW
WWWWWWWWWWWWWWWW
WWWWWWWWWWWWWWWW