WWWWWWWWWWWWWWWW
WWWWWWWWWWWWWWWW
WWBFFFFFFFFBFFWW
WWBFFFFFFFFBFFWW
WWBFFFFFFFFBFFWW
WWFBFFFFBFFFBFWW
WDFFBFFFFBFFFFDW
WDFFFBFFFFBFFFDW
WDFFFFBFFFFBFFDW
WWFBFFFBFFFFBFWW
WWFFBFFFFFFFFBWW
WWFFBFFFFFFFFBWW
WWFFBFFFFFFFFBWW
WWWWWWWWWWWWWWWW
WWWWWWWWWWWWWWWW