WWWWWWWWWWWWWWWW
WWWWWWWWWWWWWWWW
WWFFIFFFFFFFFIWW
WWFFIFFFFFFFFIWW
WWFFIFFFFFFFFIWW
WWFIFFFIFFFFIFWW
WDFFFFIFFFFIFFDW
WDFFFIFFFFIFFFDW
WDFFIFFFFIFFFFDW
WWFIFFFFIFFFIFWW
WWIFFFFFFFFIFFWW
WWIFFFFFFFFIFFWW
WWIFFFFFFFFIFFWW
WWWWWWWDDWWWWWWW
WWWWWWWWWWWWWWWW