WWWWWWWWWWWWWWWW
WWWWWWWWWWWWWWWW
WWFFFFFFFFFFBFWW
WWFFFFFFFFFFBFWW
WWFFFFFFFFFFBFWW
WWFBBBBBBBBFBFWW
WDFBFFFFFSBFBFWW
WDFBFFFBBBBFBFWW
WDFBFFFFFFFFBFWW
WWFBBBBBBBBBBFWW
WWFFFFFFFFFFFFWW
WWFFFFFFFFFFFFWW
WWFFFFFFFFFFFFWW
WWWWWWWWWWWWWWWW
WWWWWWWWWWWWWWWW