WWWWWWWWWWWWWWWW
WWWWWWWWWWWWWWWW
WWFBFFFFFFFFFFWW
WWFBFFFFFFFFFFWW
WWFBFFFFFFFFFFWW
WWFBFBBBBBBBBFWW
WWFBFBSFFFFFBFDW
WWFBFBBBBFFFBFDW
WWFBFFFFFFFFBFDW
WWFBBBBBBBBBBFWW
WWFFFFFFFFFFFFWW
WWFFFFFFFFFFFFWW
WWFFFFFFFFFFFFWW
WWWWWWWWWWWWWWWW
WWWWWWWWWWWWWWWW