WWWWWWWWWWWWWWWW
WWWWWWWWWWWWWWWW
WWBFFFBFFFFBFFWW
WWBFFFBFFFFBFFWW
WWBFFFBFFFFBFFWW
WWBFBFBFBFFFFFWW
WDFFBFFFBFBBBFDW
WDFFBFFFBFBFBFDW
WDBBBFFFBFFFBFDW
WWFFBBBFBBBFBFWW
WWFFFFFFFFBFBFWW
WWFFFFFFFFBFBFWW
WWFFFFFFFFBFBFWW
WWWWWWWWWWWWWWWW
WWWWWWWWWWWWWWWW