WWWWWWWWWWWWWWWW
WWWWWWWWWWWWWWWW
WWFFBFFFFFFFFBWW
WWFFBFFFFFFFFBWW
WWFFBFFFFFFFFBWW
WWFBFFFBFFFFBFWW
WWFFFFBFFFFBFFDW
WWFFFBFFFFBFFFDW
WWFFBFFFFBFFFFDW
WWFBFFFFBFFFBFWW
WWBFFFFFFFFBFFWW
WWBFFFFFFFFBFFWW
WWBFFFFFFFFBFFWW
WWWWWWWWWWWWWWWW
WWWWWWWWWWWWWWWW