WWWWWWWWWWWWWWWW
WWWWWWWDDWWWWWWW
WWFFFFFFFFFFFFWW
WWFFFFFFFFFFFFWW
WWFFFFFFFFFFFFWW
WWFBBBBBBBBBBFWW
WWFBFFFFFFFFFFDW
WWFBFFFFFFFFFFDW
WWFBFFFFFFFFFFDW
WWFBBBBBBBBBBFWW
WWFFFFFFFFFFFFWW
WWFFFFFFFFFFFFWW
WWFFFFFFFFFFFFWW
WWWWWWWWWWWWWWWW
WWWWWWWWWWWWWWWW