WWWWWWWWWWWWWWWW
WWWWWWWWWWWWWWWW
WWFFFFFFFFBFBFWW
WWFFFFFFFFBFBFWW
WWFFFFFFFFBFBFWW
WWFFBBBFBBBFBFWW
WDBBBFFFBFFFBFDW
WDFFBFFFBFBFBFDW
WDFFBFFFBFBBBFDW
WWBFBFBFBFFFFFWW
WWBFFFBFFFFBFFWW
WWBFFFBFFFFBFFWW
WWBFFFBFFFFBFFWW
WWWWWWWWWWWWWWWW
WWWWWWWWWWWWWWWW