WWWWWWWWWWWWWWWW
WWWWWWWWWWWWWWWW
WWFFFFFFFFFFFFWW
WWFFFFFFFFFFFFWW
WWFFFFFFFFFFFFWW
WWFBBBBBBBBBBFWW
WDFFFFFFFFFFBFDW
WDFFFFFFFFFFBFDW
WDFFFFFFFFFFBFDW
WWFBBBBBBBBBBFWW
WWFFFFFFFFFFFFWW
WWFFFFFFFFFFFFWW
WWFFFFFFFFFFFFWW
WWWWWWWWWWWWWWWW
WWWWWWWWWWWWWWWW