WWWWWWWWWWWWWWWW
WWWWWWWWWWWWWWWW
WWFFFFFFFFFFFFWW
WWFFFFFFFFFFFFWW
WWFFFFFFFFFFFFWW
WWFPPPFFFFPPPFWW
WDFPFFFFFFFFPFWW
WDFPFPPPPPPFPFWW
WDFPFFFFFFFFPFWW
WWFPPPFFFFPPPFWW
WWFFFFFFFFFFFFWW
WWFFFFFFFFFFFFWW
WWFFFFFFFFFFFFWW
WWWWWWWWWWWWWWWW
WWWWWWWWWWWWWWWW