WWWWWWWWWWWWWWWW
WWWWWWWWWWWWWWWW
WWFFBFFFFFFFFBWW
WWFFBFFFFFFFFBWW
WWFFBFFFFFFFFBWW
WWFBFFFBFFFFBFWW
WDFFFFBFFFFBFFWW
WDFFFBFFFFBFFFWW
WDFFBFFFFBFFFFWW
WWFBFFFFBFFFBFWW
WWBFFFFFFFFBFFWW
WWBFFFFFFFFBFFWW
WWBFFFFFFFFBFFWW
WWWWWWWWWWWWWWWW
WWWWWWWWWWWWWWWW