WWWWWWWWWWWWWWWW
WWWWWWWWWWWWWWWW
WWFFBFFFFBFFFBWW
WWFFBFFFFBFFFBWW
WWFFBFFFFBFFFBWW
WWFFFFFBFBFBFBWW
WDFBBBFBFFFBFFDW
WDFBFBFBFFFBFFDW
WDFBFFFBFFFBBBDW
WWFBFBBBFBBBFFWW
WWFBFBFFFFFFFFWW
WWFBFBFFFFFFFFWW
WWFBFBFFFFFFFFWW
WWWWWWWWWWWWWWWW
WWWWWWWWWWWWWWWW