WWWWWWWWWWWWWWWW
WWWWWWWWWWWWWWWW
WWBFFFFFFFFBFFWW
WWBFFFFFFFFBFFWW
WWBFFFFFFFFBFFWW
WWFBFFFFBFFFBFWW
WWFFBFFFFBFFFFDW
WWFFFBFFFFBFFFDW
WWFFFFBFFFFBFFDW
WWFBFFFBFFFFBFWW
WWFFBFFFFFFFFBWW
WWFFBFFFFFFFFBWW
WWFFBFFFFFFFFBWW
WWWWWWWWWWWWWWWW
WWWWWWWWWWWWWWWW