WWWWWWWWWWWWWWWW
WWWWWWWWWWWWWWWW
WWFFFFBFFBFFFFWW
WWFFFFBFFBFFFFWW
WWFFFFBFFBFFFFWW
WWFFFFBFFBFFFFWW
WWFFFFBFFBFFFFDW
WWFFFFBFFBFFFFDW
WWFFFFBFFBFFFFDW
WWFFFFBFFBFFFFWW
WWFFFFBFFBFFFFWW
WWFFFFBFFBFFFFWW
WWFFFFBFFBFFFFWW
WWWWWWWWWWWWWWWW
WWWWWWWWWWWWWWWW