WWWWWWWWWWWWWWWW
WWWWWWWDDWWWWWWW
WWFFFFFFFFFFFFWW
WWFFFFFFFFFFFFWW
WWFFFFFFFFFFFFWW
WWFBBBBBBBBBBFWW
WDFBFFFFFFFFBFWW
WDFBFBBBBFFFBFWW
WDFBFBSFFFFFBFWW
WWFBFBBBBBBBBFWW
WWFBFFFFFFFFFFWW
WWFBFFFFFFFFFFWW
WWFBFFFFFFFFFFWW
WWWWWWWWWWWWWWWW
WWWWWWWWWWWWWWWW