WWWWWWWWWWWWWWWW
WWWWWWWDDWWWWWWW
WWFFBFFFFBFFFBWW
WWFFBFFFFBFFFBWW
WWFFBFFFFBFFFBWW
WWFFFFFBFBFBFBWW
WWFBBBFBFFFBFFWW
WWFBFBFBFFFBFFWW
WWFBFFFBFFFBBBWW
WWFBFBBBFBBBFFWW
WWFBFBFFFFFFFFWW
WWFBFBFFFFFFFFWW
WWFBFBFFFFFFFFWW
WWWWWWWDDWWWWWWW
WWWWWWWWWWWWWWWW