WWWWWWWWWWWWWWWW
WWWWWWWDDWWWWWWW
WWFFFFFFFFBFBFWW
WWFFFFFFFFBFBFWW
WWFFFFFFFFBFBFWW
WWFFBBBFBBBFBFWW
WWBBBFFFBFFFBFWW
WWFFBFFFBFBFBFWW
WWFFBFFFBFBBBFWW
WWBFBFBFBFFFFFWW
WWBFFFBFFFFBFFWW
WWBFFFBFFFFBFFWW
WWBFFFBFFFFBFFWW
WWWWWWWDDWWWWWWW
WWWWWWWWWWWWWWWW