WWWWWWWWWWWWWWWW
WWWWWWWDDWWWWWWW
WWFFBFFFFFFFFBWW
WWFFBFFFFFFFFBWW
WWFFBFFFFFFFFBWW
WWFBFFFBFFFFBFWW
WDFFFFBFFFFBFFWW
WDFFFBFFFFBFFFWW
WDFFBFFFFBFFFFWW
WWFBFFFFBFFFBFWW
WWBFFFFFFFFBFFWW
WWBFFFFFFFFBFFWW
WWBFFFFFFFFBFFWW
WWWWWWWDDWWWWWWW
WWWWWWWWWWWWWWWW