WWWWWWWWWWWWWWWW
WWWWWWWDDWWWWWWW
WWBFFFBFFFFBFFWW
WWBFFFBFFFFBFFWW
WWBFFFBFFFFBFFWW
WWBFBFBFBFFFFFWW
WWFFBFFFBFBBBFWW
WWFFBFFFBFBFBFWW
WWBBBFFFBFFFBFWW
WWFFBBBFBBBFBFWW
WWFFFFFFFFBFBFWW
WWFFFFFFFFBFBFWW
WWFFFFFFFFBFBFWW
WWWWWWWDDWWWWWWW
WWWWWWWWWWWWWWWW