WWWWWWWWWWWWWWWW
WWWWWWWDDWWWWWWW
WWOOOOOOOOOOOOWW
WWOOOOOOOOOOOOWW
WWOOOOOOOOOOOOWW
WWOOOOOOOOOOOOWW
WWOOOOOOOOOOOOWW
WWOOOOOOOOOOOOWW
WWOOOOOOOOOOOOWW
WWOOOOOOOOOOOOWW
WWOOOOOOOOOOOOWW
WWOOOOOOOOOOOOWW
WWOOOOOOOOOOOOWW
WWWWWWWDDWWWWWWW
WWWWWWWWWWWWWWWW