WWWWWWWWWWWWWWWW
WWWWWWWDDWWWWWWW
WWFFFFFFFFFFFFWW
WWFFFFFFFFFFFFWW
WWFFFFFFFFFFFFWW
WWFBBBBBBBBBBFWW
WWFBFFFFFFFFBFDW
WWFBFFFBBBBFBFDW
WWFBFFFFFSBFBFDW
WWFBBBBBBBBFBFWW
WWFFFFFFFFFFBFWW
WWFFFFFFFFFFBFWW
WWFFFFFFFFFFBFWW
WWWWWWWWWWWWWWWW
WWWWWWWWWWWWWWWW