WWWWWWWWWWWWWWWW
WWWWWWWDDWWWWWWW
WWFFFFFFFFBBBBWW
WWFFFFFFFFBBBBWW
WWFFFFFFFFBBBBWW
WWFFFFFFFFBBBBWW
WDFFFFFFFFFBBBWW
WDFFFFFFFFFFFSWW
WDFFFFFFFFFBBBWW
WWFFFFFFFFBBBBWW
WWFFFFFFFFBBBBWW
WWFFFFFFFFBBBBWW
WWFFFFFFFFBBBBWW
WWWWWWWDDWWWWWWW
WWWWWWWWWWWWWWWW