WWWWWWWWWWWWWWWW
WWWWWWWDDWWWWWWW
WWFPPPPFFPPPPFWW
WWFPPPPFFPPPPFWW
WWFPPPPFFPPPPFWW
WWFPPPPFFPPPPFWW
WWFPPFFFFFFPPFDW
WWFPPFFFFFFPPFDW
WWFPPPPPPPPPPFDW
WWFPPPPPPPPPPFWW
WWFFFFFFFFFFFFWW
WWFFFFFFFFFFFFWW
WWFFFFFFFFFFFFWW
WWWWWWWDDWWWWWWW
WWWWWWWWWWWWWWWW