WWWWWWWWWWWWWWWW
WWWWWWWDDWWWWWWW
WWBFFFFFFFFBFFWW
WWBFFFFFFFFBFFWW
WWBFFFFFFFFBFFWW
WWFBFFFFBFFFBFWW
WDFFBFFFFBFFFFWW
WDFFFBFFFFBFFFWW
WDFFFFBFFFFBFFWW
WWFBFFFBFFFFBFWW
WWFFBFFFFFFFFBWW
WWFFBFFFFFFFFBWW
WWFFBFFFFFFFFBWW
WWWWWWWDDWWWWWWW
WWWWWWWWWWWWWWWW