WWWWWWWWWWWWWWWW
WWWWWWWDDWWWWWWW
WWFFFFFFFFFFFFWW
WWFFFFFFFFFFFFWW
WWFFFFFFFFFFFFWW
WWFIFIFIIFIFIFWW
WWFFFFFFFFFFFFDW
WWFIFIFIIFIFIFDW
WWFFFFFFFFFFFFDW
WWFIFIFIIFIFIFWW
WWFFFFFFFFFFFFWW
WWFFFFFFFFFFFFWW
WWFFFFFFFFFFFFWW
WWWWWWWDDWWWWWWW
WWWWWWWWWWWWWWWW