WWWWWWWWWWWWWWWW
WWWWWWWDDWWWWWWW
WWPPPPPFFPPPPPWW
WWPPPPPFFPPPPPWW
WWPPPPPFFPPPPPWW
WWPFFFPPPPFFFPWW
WDPFPPPFFPPPFPDW
WDFFPFFFFFFPFFDW
WDPFPPPFFPPPFPDW
WWPFFFPPPPFFFPWW
WWPPPPPFFPPPPPWW
WWPPPPPFFPPPPPWW
WWPPPPPFFPPPPPWW
WWWWWWWDDWWWWWWW
WWWWWWWWWWWWWWWW