WWWWWWWWWWWWWWWW
WWWWWWWDDWWWWWWW
WWBBBBBFFBBBBBWW
WWBBBBBFFBBBBBWW
WWBBBBBFFBBBBBWW
WWBBBBBFBBBBBBWW
WDBBBBBFBBBBBBWW
WDFFFFFBFFFFFFWW
WDBBBBBFBBBBBBWW
WWBBBBBFBBBBBBWW
WWBBBBBFFBBBBBWW
WWBBBBBFFBBBBBWW
WWBBBBBFFBBBBBWW
WWWWWWWDDWWWWWWW
WWWWWWWWWWWWWWWW