WWWWWWWWWWWWWWWW
WWWWWWWDDWWWWWWW
WWFFFFFFFFFFFFWW
WWFFFFFFFFFFFFWW
WWFFFFFFFFFFFFWW
WWFIFIFIIFIFIFWW
WDFFFFFFFFFFFFWW
WDFIFIFIIFIFIFWW
WDFFFFFFFFFFFFWW
WWFIFIFIIFIFIFWW
WWFFFFFFFFFFFFWW
WWFFFFFFFFFFFFWW
WWFFFFFFFFFFFFWW
WWWWWWWDDWWWWWWW
WWWWWWWWWWWWWWWW