WWWWWWWWWWWWWWWW
WWWWWWWWWWWWWWWW
WWBBBBBFFBBBBBWW
WWBBBBBFFBBBBBWW
WWBBBBBFFBBBBBWW
WWBBBBBBFBBBBBWW
WDBBBBBBFBBBBBDW
WDFFFFFFBFFFFFDW
WDBBBBBBFBBBBBDW
WWBBBBBBFBBBBBWW
WWBBBBBFFBBBBBWW
WWBBBBBFFBBBBBWW
WWBBBBBFFBBBBBWW
WWWWWWWDDWWWWWWW
WWWWWWWWWWWWWWWW