WWWWWWWWWWWWWWWW
WWWWWWWWWWWWWWWW
WWFFFFFFFFFFFFWW
WWFFFFFFFFFFFFWW
WWFFFFFFFFFFFFWW
WWFFFFFFFFFFFFWW
WWFFFFFFFFFFFFWW
WWFFFFFBFFFFFFWW
WWFFFFFFFFFFFFWW
WWFFFFFFFFFFFFWW
WWFFFFFFFFFFFFWW
WWFFFFFFFFFFFFWW
WWFFFFFFFFFFFFWW
WWWWWWWWWWWWWWWW
WWWWWWWWWWWWWWWW