WWWWWWWWWWWWWWWW
WWWWWWWWWWWWWWWW
WWFFFFBFFBFFFFWW
WWFFFFBFFBFFFFWW
WWFFFFBFFBFFFFWW
WWFFFFBFFBFFFFWW
WDFFFFBFFBFFFFWW
WDFFFFBFFBFFFFWW
WDFFFFBFFBFFFFWW
WWFFFFBFFBFFFFWW
WWFFFFBFFBFFFFWW
WWFFFFBFFBFFFFWW
WWFFFFBFFBFFFFWW
WWWWWWWDDWWWWWWW
WWWWWWWWWWWWWWWW