WWWWWWWWWWWWWWWW
WWWWWWWDDWWWWWWW
WWFFBFFFFBFFFBWW
WWFFBFFFFBFFFBWW
WWFFBFFFFBFFFBWW
WWFFFFFBFBFBFBWW
WWFBBBFBFFFBFFDW
WWFBFBFBFFFBFFDW
WWFBFFFBFFFBBBDW
WWFBFBBBFBBBFFWW
WWFBFBFFFFFFFFWW
WWFBFBFFFFFFFFWW
WWFBFBFFFFFFFFWW
WWWWWWWWWWWWWWWW
WWWWWWWWWWWWWWWW