WWWWWWWWWWWWWWWW
WWWWWWWDDWWWWWWW
WWIIIIIFFIIIIIWW
WWIIIIIFFIIIIIWW
WWIIIIIFFIIIIIWW
WWIIIIIIFIIIIIWW
WDIIIIIIFIIIIIDW
WDFFFFFFIFFFFFDW
WDIIIIIIFIIIIIDW
WWIIIIIIFIIIIIWW
WWIIIIIFFIIIIIWW
WWIIIIIFFIIIIIWW
WWIIIIIFFIIIIIWW
WWWWWWWDDWWWWWWW
WWWWWWWWWWWWWWWW