WWWWWWWWWWWWWWWW
WWWWWWWWWWWWWWWW
WWFBFBFFFFFFFFWW
WWFBFBFFFFFFFFWW
WWFBFBFFFFFFFFWW
WWFBFBBBFBBBFFWW
WWFBFFFBFFFBBBDW
WWFBFBFBFFFBFFDW
WWFBBBFBFFFBFFDW
WWFFFFFBFBFBFBWW
WWFFBFFFFBFFFBWW
WWFFBFFFFBFFFBWW
WWFFBFFFFBFFFBWW
WWWWWWWDDWWWWWWW
WWWWWWWWWWWWWWWW