WWWWWWWWWWWWWWWW
WWWWWWWDDWWWWWWW
WWFFFFBFFBFFFFWW
WWFFFFBFFBFFFFWW
WWFFFFBFFBFFFFWW
WWFFFFBFFBFFFFWW
WDFFFFBFFBFFFFWW
WDFFFFBFFBFFFFWW
WDFFFFBFFBFFFFWW
WWFFFFBFFBFFFFWW
WWFFFFBFFBFFFFWW
WWFFFFBFFBFFFFWW
WWFFFFBFFBFFFFWW
WWWWWWWWWWWWWWWW
WWWWWWWWWWWWWWWW