bGbbb------L---L
-----------L---L
-----------L---L
--bbLbbbbbbLBBBL
bbb-L---GG-----L
----L---BB---bbL
----L---bBbbbbbL
---bbbb-bbbbb--L
--------bb-----L
----G----------L
bbbbbbbbbBBBBBBB