---------L------
---------L------
---------L------
RRRRR-G---------
L--BBBbbBB------
L---------RRRRRR
L---------------
LRRRRRRRRRR-----
------E---------
LBBBBbBBBBBBbbBB
L---------------