----------------
----------------
----------------
----------------
----------------
----------------
LL-bbbbbELBBB-BB
LBLL-G-LLBLLLLLL
GLBLbLbLBLGbbLbb
b-LBLLLBL-b-LLL-
-bLLBLBLLb-L---L