-----bbbb-L-----
----RbGGb-L-----
-bbbRbbbb-LRRRR-
-bGb------L---RR
-bbb------L-----
----------L-----
----------L-----
----bb----L-----
----bb----L-----
----------L-----
----------L-----