L-G-------bB---L
BbbBBb----bB---L
----------bB---L
---------GbB---L
-E-------bBB---L
-------GbBBB---L
BBBBBbbbbBBBLbbb
------M-----LBbb
bbBbBbbbBBbbBbbb
------------BBbB
------E-----BBBB