BBLEL-L-L-L-L-L-
bbLBL-L-L-L-L-LG
BbLBLBLGLbbbLbbb
bbLBLbLBL-L-L-Lb
bBLBLBLBLBL-L-Lb
bbLBLBLBLbL-L-Lb
bBLBLBLBLBLBbbLb
bbLbLbLbLBLbL-Lb
--L-L-L-L-L-LBLb
-ML-L-L-L-L-LbLb
GbLbbbbbbbbbbbbb