RRRRRRRRRRRRRRRL
----------E----L
L-L---L-GGGGGG-L
L-LL--L------G-L
L-LL--L------G-L
L-LLL-L------G-L
L-L-L-L------G-L
L-L-L-L-----GG-L
L-L-L-L-----G--L
L-L-L-L----GG--L
L-L-L-L----G---L