----------------
----------------
bbbbbbbbbbbbbbL-
G-EG------bbL-L-
bbbbL-LbbbLbbbL-
----bbb---L-L-L-
-G-EbbbL--L-L-L-
bbbbL-LLbbbbLbbb
bbL-L-L-L-L-L-L-
--L-L-L-L-L-L-L-
G-L-L-L-bbbbbbL-