bb----LbbER-----
bb----LbbL-bb---
bb----LbbLGbb---
bb-G--LbbL-bb---
b-RRLRLbbL--b---
bb-LL--bbL-b-RRR
bbLL---bbL-bb---
bbL----bbL------
bbL-GRRbbL--G---
bbbbbL-bbbbbbL--
bbbbbL-Gbbbb-L--