LBbbBB-----BLBG-
LBRRRRRRRRRbLBbb
LB---------GLB--
LB-----G---bLb--
LB----BbbbBBLB--
LB---------BLBRR
LB-G-------BLB--
LBbbbb-----bLb--
L----------bLB--
L-----E-----L---
bbbbBbbbbbBbbbbB