----------Lbbb-L
b---------Lb---L
-----EG---Lb---L
-bbbbbbbbbbb---L
---G--------G--L
RbbbbRRR---Lb--L
---------G-L---L
-------bbbbb---L
---------------L
---------------L
bbbbbBBbbbBBBBbb