L---------------
L---------------
L-----B---G-----
LbbbbBBbbbbbbbbb
L---------------
L---------------
L---------------
L---------------
L---------------
LG-GGG-----E----
bbbbbBBBbbbBbbBB