----------------
----------------
----------------
----------------
----------------
-RRRRRRRR-M-----
--------bbbbb--G
---------------L
---------------L
--G------------L
bbbbRRRRRR---G-L