----------------
----------------
----------------
----------------
----------------
----------------
----------------
-------------E--
RRR-E--RRRRR-bbb
LbbBbbb-bbbbbbbL
LbbGbbb-BG---LbL