------GLLLbbbLLb
----GLLLbbbLLLLL
--GLLLbbbLLL----
-LLLbbbLLL------
LLbbbLLL--------
LLLLLL----------
Lbbbbb----------
Lbbbbb----------
LLLLLLG---------
LLbbbLLLG-------
-LLLbbbLLLGE----