----------------
----------------
----------------
----------------
----------------
----------------
---G------------
LBbb------------
LBGbb-G---------
L--bGbbb--------
L--b-b--bbbG----