----------------
ME-RRRR---------
--L----L--------
-LL----L--------
LL-----L--------
LL-----L--------
-LL----L--------
--LL---L--------
---LL--L--------
----L--LL-------
-----bGLLRRRRLR-