----------------
--------M-------
------BbLbBRRRRR
------B-L-BG----
----BbbGL-bbB---
----B---L---B---
----BG--L--GBG--
B---bbb-L-bbbbB-
B-------L-----B-
b-------L-----B-
B-------Lbbbbbbb