----------------
----------------
----------------
----------------
----------------
----------------
LRRRRRRLLLLLbbbb
bL-----LGG-L-L-L
bbLL----LLGL-L-L
bbbL------LLGLGL
bbbL-------LLLLL