GGG-----bbbLbGb-
bbb-----bGbLGbG-
--------bbbLbGb-
-----------LRL--
-----------L----
-----------L----
-----------L----
-----------L----
-----------L----
-----------L----
bbbBBBBBbbbbbbbb