----------------
bbb-------E-----
--G-------L-----
---------bLb----
bbbb-----GLG----
---G----bbLbb---
--------G-L-G---
bbbbb--bbbLbbb--
----G--G--L--G--
-M--------L-----
bbbbbbbbbbbbbbbb