------------L---
------------L---
------------L---
------------L---
------------L---
------------L---
------------L---
------------L---
------------L---
-E---M------L---
BBbbBbBBBBbbbBBB