L-------L----L-B
L-----bbL----L-B
L-------L----L-b
LBbbB---L---bLLB
L--Gb---L--EbbL-
L---bb--L--bbBL-
L----B--L--BG-L-
L----B--L--B--L-
L-----bbbbb---L-
L-----bbbbb---L-
bbbbbbbbbbbbbbbb