--------------LL
-------------LLL
---------------L
--------------LL
-E-----------LLL
RRRRRRRRRRRRRLLL
RRRRRRRRRRRRRLLL
-RRRRRRRRRRRRLLL
---RRRRRRRRRRLLL
-----RRRRRRRRLLL
-------RRRRRRLLL