----------------
----------------
----------------
----------------
----------------
RRRRRRRRRRRRR---
-------------L--
--G---G---G-EL--
bbbbbbbbbbbbbL--
GG---------GGLRR
bbG-------Gbb---