LLLLLLLLLLLLLLLL
L-G--L-G-L--G-LL
LLLLLLLLLLLLLLLL
L-LL-L---L----LL
L-LL-L---L-LL-LL
L--L-L-LLL-LL-LL
L-L--L---L---LLL
L-LL-L-LLL-LL-LL
L-LL-L---L-LL-LL
L-LL-L---L-LL-LL
LLLLLLLLLLLLLLLL