L---------------
L---------------
L---------------
L---------------
L---------------
L---------------
L--RR------RRRRR
L----------L----
L---------GL----
bbb-bbbbbbbLRRRR
-G---------L-G--