bL----B-bLBbbbb-
bbBBBLb-bLB-----
----BLB-BLB-G-G-
--G-BLB-BLBbbbb-
bbbbBLB-BLbbbbb-
----BLb-BLB--bb-
----BLB-BLB---b-
bbLbBLb-BLB-----
--L--LB--L------
--L-GLB--L----G-
bBBbbbbbbBbbbbbb