LL-bGbbbbL---bLB
bLbb-bbbbL---bLB
---b-----L----Lb
bb-b-----LbbbLLB
bb-bbbbbbbbbbLLB
bb-b---------L-B
b--b---------L-B
b--b---------L-b
b--bG--------LbB
bbbbbbbbbbbbbLbB
-E-----------L-B