----------------
----------------
----------------
----------------
----------------
----------------
----------------
------------BBBL
----------G-BBBL
------E-bbbbbbbL
-----bbb-G-----L