------L----BLbbR
------L----BLB--
-----EL--G-BLBbb
BBBBBBbbLb-BLB--
L------BLb--LBbb
Lb------LbbbLBG-
LB-----LBB-BLB--
LBBBBB-LB-GBL---
L-----bbb-BBLBbb
L--------E--LBG-
bbbbbbbbbbbbbBbb