bbbL-------L-L-L
bBGL-------L-L-L
bBbL-------LGLGL
bBbL-------LLLLL
bBGL-------L-L-L
bBbL-------L-L-L
bBbL-------LGLGL
bbGL-------LLLLL
bbbL-------L-L-L
B-bBL-----MLGLGL
B-bBLE---Lbbbbbb