----------------
----------------
----------------
------------G--b
--------bbbbbbbb
--------b------b
--------b-EG---b
----bbbbbbbb-G-b
----b------bbbbb
----b------b----
----b------b----