----------------
----------------
----------------
----------------
------------LBBB
bbLLbbbLbbbbL---
b-bLb-bLb--bL---
bGbLb-bLb--bL---
b-bLb-bLb--bL---
b-bLbGbLbG-bL---
b-bLb-bLb--bLbbb