----------------
bb--G-----------
-bbbbbb---------
----------------
-------G--------
bbb-bbbbbbbLbb--
-----------L----
-----------L----
------E----L---G
bbbbBBB----Lbbbb
-----------L----