----------------
----------------
----------------
----------------
----------------
----------------
----------------
----------------
bbbL------------
bbbL------------
bbbLG-----------