b-bLb-bLb--bLLLL
b-LLb-bLb--bLLBB
LLLLLLLLLLLLLLB-
L-----L--bb-LLB-
L--bbbL--bGbLLBB
LRRbG-L---bbLLRR
L--bb-L--b-bL--G
L-----L-Mbb-Lbbb
LLLLLLLBBBBBLbLL
L---------BBLbL-
bbbbbL----E--bL-