bbb-----L-bbbbbb
bbb-----L-bG---E
bbb-----L-bbbbbL
--------L------L
--------L------L
--------L------L
--------L------L
--------L------L
--------L------L
M-------L------L
bbbbbbbbL--bbbbL