----------------
----------------
bBBbbbbBBBbbBBbL
----------L----L
----------L----L
--------GRRRG--L
bL-G----bb-bb--L
Bbbbbb---------L
bbbbbb---------L
BBbbb-------E--L
B-bbb-bbbbbLbbbL