----------------
----------------
--------------E-
Lbbbbbbbbbbbbbbb
Lbbbbbbbbbbbbbbb
L--------bbbRRRR
L--------bbbL---
L----G---bbbL-bb
L--bbbb--bbbL-bb
L--bbbb--bbbL---
L--bbGb--bbbL---