----------------
----------------
GGGRRRRRRGGG-GGG
bbb------bbbLbbb
bbb------bbbLbbb
bbb------bbbLbbb
bbb------bbbLbbb
bbb------bbbLbbb
bbb------bbbLbbb
bbb------bbbLbbb
bbb------bbbLbbb