-----RRRRRRR--E-
----------BBBBBL
bbbbbbRRRRRRb--L
RRRRRb----LbbbLb
-----b----L---L-
--bbLb----LG--L-
RRRRLb----LR--L-
----Lb----L---L-
----Lb----L---L-
----Lb----L---LG
GbLGLb----LbbbLb