bbbL-L-L-L-L----
bbL--L-L-LLL----
bbL--L-L-LLL----
GbL--L-L-LLL----
-----L-L-LLL----
-----L-L-LLL----
-----L-LLLL-----
-----LLLLL------
-----LLLL-------
-----LLL--------
bbbbbLE---------