----------------
----------------
bbbbbb----------
----bbb---------
-----bbb--------
------bbb------G
G-E---bbbb-----b
bbbLbbbbbbb---bb
---L----bbbbLbbb
---L--------L---
---L--------L---