LLLRRRR---------
LLL-------------
LLL-------------
LLL--G-G-G-G-G-G
LLL-------------
MLL-------------
bLLbbbbbbbbbbbbb
bLLbbbbbbbbbbbbb
-L--------------
-L----G-G-G-G-G-
bbbbbbbbbbbbbbbb