----------------
----------------
----------------
----------------
-------E--------
----------------
----------------
----------------
----------------
-----------GbbbL
-----------b-b-L