L-b--bb-b-L-BG--
L-b-bb--b-L-BB--
L-bG-bb-b-L-bB--
L-bbbb--b-L-bB--
L-bbbbbbb-L-bB-b
L---------L-Bb--
LBBBBBBbBBBBBB--
L---------------
L---------------
L------------M--
bbbbbbbbbbbbbbbb