----------------
----------------
----------------
----------------
bL--------------
bL--------------
bLGE------------
bbbL------------
bbbLG-----------
bbbbbL----------
bbbbbLGE--------