-RRRRRG---------
------bL--------
------bL--------
------bL--------
------bL--------
------bL--------
-G--E-bL--------
bbbbb--bL-------
-----b--bLG-----
G----bG--bbL---L
bbbbL-b---bLGELb