-LG------LG-----
-GL------GL-----
-LG------LG-----
-GL------GL-----
-LG------LG-----
-GL------GL-----
-LG------LG-----
-GL------GL-----
-LG------LG-----
EGL----E-GL--E--
bbbbbbbbbbbbbbbb