-------L-bbbbb--
-------L--------
-----G-L-------G
---Lbbbbbbbbbbbb
---L-----------M
---L-G--GLbbbbbb
bbbbbbbbbL------
---------L------
---------L------
---------L------
bbBbBBBBbbBBBbbb