--------L-------
--------L-------
--------L-------
bbbbbbbbL-------
--------L-------
--------L-------
RRRRRRRRL--G-E--
--------bbbbbbbL
---------------L
-M--G----------L
bbbbbbbbbbbbbbbb