b--b--b--bLL----
b--b-Gb--bLLbbbb
b--bbbb--bLb----
b--b--b--bLb-bbb
bLbb--bbLbLb-bb-
bL----BbLbLb-bbG
bL---BbbLbLb----
bL---bBbLLLb----
bL---Bb-LLbb----
bL---B---Lbbbbbb
bLbbb----L------