LLLbbbLLL------L
LbbbLLL---------
bbLLL-----------
LLLG------------
bbLLLG----------
LbbbLLLG--------
LLLbbbLLLG----GL
--LLLbbbLLL--LLL
----LLLbbbLLLLbb
-----GLLLLLLLLLL
-----LbbbbbLLbbb