L-----------LbbL
L-----E-----LbbL
L----bb-----LbbL
L-bbb--bbb--LbbL
L-bbb--bbb--Lbbb
L-bbbGGbbb--Lbb-
L----bb-----Lb--
L---bbbb----Lb--
LG-Gbbbb-G-GLbb-
bbbbbbbbbbbbbbbb
bbbbbbbbbbbbbbbb