------L---------
-G----L--------G
bbbbbbL-----bbbb
------L---------
------L---------
--G---L---G-----
bbbbbbbbbbbbbbbL
---------------L
---------------L
-------G-------L
bbbbbbbbbbbbbbbb