--RR--------G--G
bb--bL-----Lbbbb
-bb-bL----Lbbbbb
bb--bLbbbbbbGbbG
GbbGbL------E---
bbbbbbbbbbbbbbbb
----------------
----------------
----------------
----------------
----------------