----------------
M---------------
----------------
GGGGGGGG-GGGGGGG
bbbbbbbbLbbbbbbb
bbbbbbbbLbbbbbbb
---bb---Lbbbbbbb
---bb---Lbbb---b
---bb---Lbbb---b
---bb---Lbbb---b
---bb---Lbbb---b