---------------b
--------------bb
bbbE--Lbbb-----L
RRLb-bLRRLb---bL
G-Lb-b-G-Lbb-bGL
bbLbbbbbbLbbbbbL
bbL--bbbbL--bbbL
bbL---bbbL---bbL
bbL---bbbL--MbbL
bbLLbbbbbLLbbbbL
--LLbbb--LLbb--L