---------------B
---------------B
---------------B
---------------B
---------------B
---------------B
---------------B
BBBBbBBBBBBBBBGB
RRR-----RRRRRRLB
--bbbbb-----bbLB
-----Gb--b-GbGLB