----------------
----------------
----------------
----------------
----------------
----------------
----------------
----------------
----------------
RRRRRR------E--L
L----LRRRRRRLbGL