E-LbB-----L-bbbL
bbbbbbbbLbbbbbbL
RRRRRRRRLRB-RRRL
--------L-BL---L
--------L-BL---L
-G-G----L-BLG-Gb
bbBBbbbbbbBbbLbb
-------------L--
-------------L--
-------------L--
-----------GGLGG