----------------
---RRRRG--------
--L---bbb-------
--L-------------
--L------E------
--LRRRL-G-------
bbL---Lbbb------
----G-Lbbb---E--
--bbb-LR-RRRG-RR
-G------L---bb-E
-bbb----L-------