B-----------L---
B-----------L---
bLbbbbb-----L---
bLRRRRRR---LbbbB
bL---------L----
bLG----bBbbL----
bLBRRRRbbbbL----
bL---BbbBbBbbL--
bL-BbBbbBBBBbbbL
bL-bbbbbBBBBBbbL
BBbbbBBBBBBBBBbb