----------------
----------------
---ERRRLR-----RR
-bbbb--L----bb-R
-bbbb--L----bb-R
-bGGb--L------RR
-bbbb--LRRR-----
-------L--L-----
--RRRR-L--L-----
----------L-----
-----bbbb-L-----