---BBBbbbBBBbbbb
RR--------------
----------------
----------------
----------------
-------------B-B
---BBBBBBBBBBB-B
G----------G-GEB
b--bbbbbbbbbbbbb
----------------
bbbbbbbbbbbbbbbb