----------------
bL--------------
-L--------------
BB----G------G--
----bbbbbbLbbbbb
----------L-----
bL--------L-----
-LLE------L-----
-L--LbbbbbbbbbbL
BB--LBBBBBBBBBBL
----LB----G---BL