----------------
----------------
----------------
----------------
----------------
----------------
RRRRRRRRRRRRRRRR
-------L-----E-L
G------L---LBBBB
RRRL---L---L----
---L---L---BBBBL