----------------
----G-------E---
---bbbbLbbbbbbbb
--bbb--L--------
-bbb---L--------
bbb----L--------
bbb----L----G---
bbbLbbbbbbbbbbbb
b--L------------
---L------------
---L------------