----------------
----------------
----------------
----------------
----------------
----------------
----------------
--G-------------
--BBBBLBBBBBBBBB
-b----Lb-RRRRRRR
bRRRRRLBL------G