----------------
----------------
----------------
----------------
----------------
----------------
BLEbbbbb-LLB----
LBLL-G-LLBL-----
GLBLbLbLBLGb----
b-LBLLLBL-b-----
-bLLBLBLLb------