-BBBBBBBBBBBBBBB
RBbLRRRRRRRRRRRB
RRbL-----------B
-RRL-G---------B
G--Lbb--G------B
bBbLLRbbb-G----B
LRbbRLRRbbb-G--B
LRRRRRLRRRbbb-GB
LRRRRRRLRRRRbbbB
LRRRRRRRLRRRRRbb
LRRRRRRRRLRRRRRb