---LGE------L---
LbbbbL------L---
L----L------L---
L----L----------
L----L----------
L----L------G---
L----LbbbbbbbbLb
L-------------L-
L-------------L-
L-------------L-
bbbbbbbbbbbbbbbb