----------------
----------------
------RRRRR-G---
---------G--LLL-
---R-R------L--L
--R-L-R--G--L---
--G-L-G-----L---
--G-L-G--G--L--L
----L-------LLL-
----L----G------
bbbbbbbbbbbbbbbb