LbBbbbbb-----bbB
L-BBbbBbb-----bB
L------LbbG-----
BbbbbBbLbbb-----
bbbbBbBLBbbb----
-------LBBbbbG--
--G----LBBBbbbbB
LbbBbbbBB---E---
LbBbbbB--LbbBBBb
L--------L------
L---G----L------