----------------
----------------
-----G----G-----
GGbbbbbbbbbbbbbb
bb--------------
-------------Lbb
-------------L--
-------------L--
------G-E-G--L--
---LbbbbbbbbbbLR
---L----------L-