----------------
----------------
----------------
----------------
----------------
----------------
----------------
----------------
-RRRRRRL-----LRR
-------LRRRRRL--
-G-----L-----L--