---G----GRLbb---
-bbb---bb-L-----
----------L-----
-----G----L-----
----bbb---L-G---
-G--------Lbbbb-
bb--------------
----------------
----------------
----------------
bbbbbbbbbbbbbbbb