L-L-L-L---GG---L
L-L-L-L---G----L
L-L-L-L---G----L
L-L-L-L---G----L
L-L-L-L---G----L
L-L-L-L---G----L
L-L-LLL--------L
L-L--LL--------L
L-L--LL---G----L
L-L---L--------L
bbbbbbbbbbbbbbbL