---------E------
-----M----------
bbbbLLLLLLL-----
-b--L-----------
Lb--L-----------
Lb--L-----------
Lb--L-----------
Lb--L-----------
Lb--L-----------
Lb--L-----------
Lb--L-----------