L--------------L
LG-------------L
LL-------------L
L--------------L
LG-------------L
LL-------------L
L--------------L
LG-------------L
LL-------------L
LG-------------L
bbbbbbbL-------L