bbbbbbbbbbbbbbbL
bb------------bL
b--------------L
----G-----G--G-L
RRRRRRRRRRRRRRRL
---------------L
-------------E-L
--bbbbbbbbbbbbbL
-bbGbbBbBb-G-bbL
--bbbbbbbbbbbbBL
BBBbbbBBbbbbBBbb