----------------
----------------
----------------
----------------
----------------
----------------
----------------
----------------
--------------L-
RRRRRRRRRRRRRRL-
-----------E--L-