L------Lb----b--
L------Lb--G-bE-
Lbbbbbbbbbbbbbbb
Lb------b----b--
Lb------b----b--
Lb------b----b--
Lb------b----b--
Lb------b----b--
Lb---G--b--G-b--
LLLbLbbLbLbbLbLb
LLbbLbbL-LbbLMLb