---L------------
---L------------
---L------------
bbbbbbbbbbbbbbLb
--------------L-
--------------L-
----------E-G-LR
------Lbbbbbbbbb
------L---------
------L---------
bbbbbbbbbbbbbbbb