-----------Lbbbb
-----------LGBbB
-----------LbBbB
GRRRRRRRRRRLbBbB
LG---------LGBbB
bLG--------LbBbB
bbLG-------LbBbB
bbbLG------LGbbb
bbbbLG-----Lbbbb
bbbbbLG---LBb-Bb
bbbbbbL--ELBb-Bb