----------------
----M-----------
bbbbbbbbbbbbbbbL
---------------L
---------------L
--G--------GB--L
bbbbbbbbbbbbBbbL
---------------L
---------------L
G-------G--B---L
bbbbbbbbbbbBbbbL