----------------
RRRRRRRRRRRRRRRR
L---------------
L---------------
L---------------
L---------------
L----ELBL-------
BBBBBBBBLBLB-M--
LRRRRRRRL-Lbbbbb
L-------L-Lb-Gb-
L-------L-Lb--Gb