----G----G---GE-
bbbbbbbbbbbbbbb-
---------------L
---------------L
---------------L
---------------L
--------------bL
--------------GL
---------------L
-------------bbL
-------------G-L