----------------
----------------
bbbbbbL---------
------L---E-G---
------LbLbbbbbbL
------L-L------L
RRRRRRL-LG-----L
------L-bbbbbbbb
------L---------
------LRRRRRRRRR
------L---------