---L----------L-
--GL----------L-
bbbL------E---L-
--------LbbbbbLb
--------LRRRRRRR
-----G--LG------
bbbbbbbbbL------
---------L------
---------L------
---------L------
---------L------