------L---------
------L---------
------L---------
------LG---G---G
------L---------
------L--------b
------L-----bbbb
------L--bbbbbbb
------L---bbbbbb
------L----bbbbb
------L------bbb