RRR-------------
---RR-----------
-----RR---------
-------RR-------
---------RRG-G--
bBbBbBbBbBbBbBbB
--G---G---RRRRRR
BbBbBbBbBL-----L
BBBBBBBBBL--G--L
--------bbbbbbbL
--------b------L