------L-----bbbb
------L-----bbbb
------L-----bbbb
------L---------
------L---------
------L---------
------L---------
------L---------
-----RL---------
E--Gb-L---------
bbbbb-LbbbGbbbbb