----------------
--------RRRRRRRR
E-------L------L
b------EL----G-L
----bbbbLbbbbbbb
--------L-------
--------L-------
--------L--b----
--------L--G----
--------L--b----
--------L-------