Lbbbbbbbbbbbbbbb
L---------------
L------E--------
L--LbbbbbLbbbbbL
L--L--L--L--L--L
L--LGGLGGLGGLGGL
L--LbbbbbLbbbbbL
L---------------
L---------------
L-------------M-
Lbbbbbbbbbbbbbbb