R-L-RR-G--RRRR-L
-bLb-G---------L
--L--G----RRRRRL
RRLRR----------L
G-L-G----------L
G-L-G-------RRRL
--L------------L
--L------------L
--L---E--------L
bbBbbbbbbbBbbbbb
bBBbbbbBBBBBbbbb