---L---bL-L--b-L
LRRL----b-L-b--L
L---------Lb----
L--------RLb----
LRRL--bbb-Lb-M-G
---L--bbb-Lbbbbb
---L--bbb-Lb-bbb
-GGL--bGb-Lb-bbG
LRRLE-bbb-Lb-bbb
LRRRRR----L-----
LbbbbbbbLbLbbbbb