Lb---bG-b----b-L
Lb---bb--bbbb--L
L------RRRRRRRRL
L---------------
L---GGG------GGG
L---LbL------LbL
L---LbL------LbL
L---LbL------LbL
L---LbL------LbL
LGGGLGLGGGGGGLGL
bbbbbbbbbbbbbbbb