L---------------
L---------------
L---------------
LL--------------
LLL-----------E-
LLLRRRRRRRRRRRRR
LLLRRRRRRRRRRRRR
LLLRRRRRRRRRRRR-
LLLRRRRRRRRRR---
LLLRRRRRRRR-----
LLLRRRRRR-------