----RRRRRRRRR---
---L------------
---L------------
---L------------
---L------------
----L-----------
RRR--L----GGRRR-
-----L----BB----
-G---L----------
-B--L----------G
---L-----------b