--------------R-
bbbbbbbbbbbbbb-L
--------b----b-L
--------b----b-L
--------b----b-L
--------b----b-L
-E--G---b---Gb-L
bbbbbbbbbbbbbb-L
------b------b-L
------b------b-L
------b------b-L