----------------
--G----E--------
BBbbBBBBBBbbBBBL
---------------L
---------------L
---RRRRRRR-LBbBB
-----L-----L----
-----L-----L----
G----Lb----L----
BBBBBBb----BBbBL
--------------LL