---LLLbbbLLLG--G
-----LLLbbbLLLLL
-------LLLbbbLLb
--------GLLLbLLb
------GLLLbbbLLb
----GLLLbbbLLLLL
--GLLLbbbLLL----
-LLLbbbLLL------
LLbbbLLL--------
LLLLLLG---------
LbbbbbL--------M