--------------L-
G------E---B--L-
BbBBBBBbBBBb--L-
--------------L-
--------------L-
--G-----------L-
BbbBBbBB------L-
--------RRRRRRL-
--------------L-
--------------L-
-------E--------