B-bBBBBBBBBBBBBB
BL-----BBbBBb-B-
BL-----B--GGG---
BL-----B-BbbBLbL
BL-M-G-B-----L-L
BLBbBb-B-GGG-L-L
BL-----B-bbb-L-L
BL-G---B-----L-L
BLBbB--B-----L-L
BL-----B-----LGL
BL-----B--G--LBL