----------------
----------------
----------------
----------------
--------------b-
-------------b--
------------b---
Gb---------bRRRL
bRRRRRLRRRb----L
G-----L-Gb--LRRL
bLRRLRLRb---L---