bbbbbbbb-bbbbb--
---------RRRR-E-
-------Lb-bbbbbL
Lbbbbbbbb-bRRRRL
L---------b-G--L
L---------bbbb--
L---------bRRRRL
L---------b----L
L---b-----b----L
L--Mb-----b----L
bLbbb-----bLGbGL