b---------------
bbbbbbbbbbbbbbbb
GE-------b------
bbbLb-bbLbLbbbbb
bbbLb-bbLbLb----
bbbLbLbbLbLb----
b-bLbLbb-bLb--G-
b-bLbLbb-bLb-bbb
bGbLbLbbLbLbLb--
b-bLbLbbLbLbLbM-
b--LbLbbLbLbLbb-