L-b------b-----b
L-b------b-----b
L-b------b-----b
L-b------b-----b
L-b-G--G-b-----b
L-bbbbbbbb-----b
L-b----b-------b
L-b-G--bG---EG-b
L-bbbbbbbbbbbbbb
L------------M--
bbbbbbbbbbbbbbbb