-----L---------L
-G---L---------L
bbbbbBBBBBBBBBBB
----------------
-G-------G--E---
bbbbbLbbbbbbbbbb
-----L----------
-----L----------
-----L----------
-----L-------G--
bbbbbbbbb-bbbbbb