-b--------------
-b--------------
-b--E-GGGGGGGGG-
-bBBBBBBBBBBBBBB
----------------
----------GG----
--------BLBBB---
---------LGG----
-------BBLBBLB--
------------L---
---------G-GL---