----------------
----------------
----------------
------------Lbbb
----------E-Lb--
-RRRRRR-----Lb-G
L------Lbbbbbbbb
L------Lb----b--
L------Lb----b--
L------Lb----b--
L------Lb----b--