---------EEE----
------GGGGGG----
GGGGG-bbbbbbb---
BBBBBB----------
----------------
----------------
----------------
----------------
----------------
----------------
----------------