BBbbbbbBBBbBBBbb
LRRRRRRRRRRRRRRR
L---L-----------
L---L-------bb--
L---L-bbbbbbbbbb
L---L-bbb-------
L---L-bbb-------
L---L--bb-bbbbbb
L---L--Lb------b
L---L--Lb---G--b
L---L--LbbLbbbbb