-----b--bL------
-----b--bL------
-----b--bL------
-----b--bL------
-----b--bL------
-----b--bL------
-----b--bL------
-----bGGbL------
-----bbbbL------
---------L------
bbbbBBBBbbbBBBBB