----------------
----------------
----------------
-----------EE---
----------------
----------GGG-bb
----GGGGG-BBBBBB
----bbbbbb-----M
----------------
----------------
----------------