bbLbbLbLbLbLbLbL
bbLbbLbLbLbLbLbL
bbLbbLbLbLbLbLbL
G-L--L-L-L-L-L-L
Lbbbbbbbbbbbbbbb
L---------------
L-------------GE
LBBBBBBBBBBBBBBB
L---------------
LG------M-------
bbbbbbbbbbbbbbbb