----------------
------E---------
bLbLbLbLbLbbLbb-
bLbLbLbLbLbbLbb-
bLbLbLbLbLbbLbb-
bLGLbL-LbLGbLbb-
bLbLbLbLbLbbLbb-
bLbLbLbLbLbbLbb-
bLbLbLbLbLbbLbb-
bLbLbLbLbLbbLbb-
bL-LbLGLbL-bLbb-