-------L-----L--
-------L------L-
-------L-------L
-------L-------L
-------L-------L
---GEG-L------L-
--bbbb-LRRRR-L--
G--------GG--L--
B--------BB--L--
-----------M-L--
bbbbbbbbbbbbbbbb