bbLLbbL-BLBLBLBG
bbLLbbL-BLBLBLBG
bbLLbbL-BLBLBLBG
bbLLbbL-BLBLBLBG
bbbbbL--BLBLBLBG
bbbbL---BLBLBLBG
LLLL----BLBLBLBG
GGGGGGGGGLBL-L-G
bbbbbbbbbbbbbbbL
GGGGGGGGGGGGGGGL
bbbbbbbbbbbbbbbb