----------------
----------------
----------------
----------------
----------------
----------------
----------------
----------------
bbbbbbbbbbbbbbbb
------------E---
G--LLLLLLLLLLLLL