----BBbbBbbBBBbB
------L-------G-
------LBBBBB-Lbb
BBB---L----bbbbb
RRL---L--G-----b
bbL-E-Lbbbbbbbbb
bbBBBL---------b
RRRRBLRRRRRRRRLb
--GLBBB-------Lb
---LbBB-------Lb
---LB---------Lb