----------------
----------------
----------------
----------------
----------------
----------------
---------E------
RRRRRRRRLBBBBBBb
L-------L-------
L------bbbbbbBBB
L------bG-b---b-