----------------
----------------
----------------
GR--------------
L-R-------------
L--G------------
L--E-Lb---------
Lbbbbb-RRRRRR---
L-GGb---Gb------
L----bGGb-R-----
RRR---bb---G----