----------------
R---------------
L-------BBBBBBL-
L-------------L-
L--E----------L-
LBBBBBBB-Lb-L-b-
LRRRRRL-bL-bL---
------L--bb--bb-
BBB-bbL-bbL--bb-
--G---L-b-LbRRb-
bbb-BBL-GLbG-GG-