LbbbL-bLE-------
LG-bL-bLbbbbbbbb
bb-bL-bLRRRRRRR-
---GL-bL------G-
bbLBB-bLbbbbbbbb
bbL----LRRRRRRRR
bbL---GL------G-
bbLbbbbbbbbbbbbb
GbLb------------
bbLb-----G----G-
bbbbbbbbbbbbbbbb