L-----------L-LL
L-----------L-LL
L-----------L-LL
L-----------L--G
L-----G------Lbb
LbbbbbbbL-----LL
L-------L-------
L-------L-------
L-------L-------
L-------L-------
bbbbbbbbbbbbbbbb