Lb-LLLLL-bL-bbb-
LbL-----LbLb-G-b
Lb-LLLLL-bL-bbb-
-bLLBLBLLb-L---L
b-LBLLLBL-b-LLL-
GLBL-L-LBLGbbLbb
LBLL-G-LLBL--L--
BL-bbbbb-LBBBLBB
BL-L-G-L-LBBLLLB
BL-LbLbLELLBLLLB
LBLBLLLBLBLLLLLL