----------L-----
----------L-----
----------L-----
-EG-------L-----
Lbbb-EG---L-----
L---bbbb--Lbbbb-
L---------------
L--------------G
L--------------L
L---------------
L--------------G