------L--------L
------L--------L
E-G---L------G-L
bbbbbbL---Lbbbbb
RR-------GL----b
-----LbbbbL-----
-----L----L---G-
-----L----Lbbbbb
-----L----------
-----L----------
G-M--L-------G--