bbL---RR-G-L----
bbL-R--R-R-L----
bbL-G-R-R-RL----
bbL--------L----
bbL--------L----
bbL--------L----
bbL--------L----
bbL--------L----
bbL--------L----
bbL-----M-------
--Lbbbbbbbbbbbbb