----------------
----------------
-----M----------
-----R------bb--
--------------bG
---------RGbL--b
----------bb-LG-
-RGR-------b--L-
G-L-G----Gb-GG-L
--L-G-G--b-----L
--L-----R-----RL