----------------
----------------
----------------
----------------
----------------
----------------
----------------
----------------
RRRRRRRLb-----b-
-------Lb-G---b-
E-G----LbbbbbbbL