----------------
----------------
----------------
----------------
----------------
----------------
----------------
-------E--------
--BBLBBBB-------
----L----bG-----
-RRRLRRRRRb-----