---G------G-----
LbbbbbbbLbbb-bbb
L-------L-------
-L-----L----R---
-L-----L---R-R--
L-------L-R---R-
L-------LR-----R
-L-----L--------
-L-----L--------
RRRRRRRRLR------
---E----L-R-----