------B---------
------B---------
------B---------
------B---------
------BRRRRRRR--
G---EGBRRRRRRGbb
bbbLbbB-----Gbb-
---L--B----Gbb--
G--L-GB---Gbb---
bbbLbbB--Gbb---L
--ML--B-Gbb---LL