bbbbbbbbbbbbbbbb
bb--Mbb----B----
b----bbRRRRB----
b--BBB--G-LBBbbb
b-b-------L-----
b-b-------L-----
b-bLbbbbBBBbbb--
b-bLb---------Bb
bG-Lb----G----bB
bbLLbbbBBbbBbBbb
bbL-------------