RRRR----L------L
B-------L----E-L
B-------LBBBBBBL
bB------L------L
bBG-----L------L
BBBB----LbbbbbbL
BbbB----L------L
bbBbBB--L------L
bbbBBBG-LBBBBBBL
bBBbbBBBL-------
bBBbBbBBL----M-G