bbb---L-bLb---b-
bbG-BBL--LbLbbb-
bbb-G-L--b-Lbb--
bbb-LBL-bbbL-bb-
G-b-L-L--b-Lb-G-
bbb-LBL-b-bb-bb-
------L---------
------L---------
---L--L---------
------L---------
bbbbbbbbbbbbbbbb