---L-L-L-L-Lbbbb
---LLL-L-L--Lbbb
---LLL-L-L--Lbbb
---LLL-L-L--LbbG
---LLL-L-L------
---LLL-L-L------
----LLLL-L------
-----LLLLL------
------LLLL------
-------LLL------
--------ELbbbbbb