-----bbL-----LEb
-bbbbbbLbbbbbbbb
b------L-----b--
bRRRRRRLRRRRRb--
b------L-----b-L
bbbbbbBLbBbbBb-L
-----bbbbb---b-L
-------LRRR-RR-L
------bLb--G---L
-----GbLb--B---L
bbbbb--L--bBb--L