----------------
----------------
----------------
-----RRR--------
L---L--RbBBBBBBB
LG--LG--b-------
bbLRBBL-B-------
-GL--GL-B-------
Lbb-LBB-B-------
LG--LG--B-------
bbL-BBL-B-------