-B-----BBBBBBB-L
-B--G--B--GG-B-L
-BBBbBBBLbbbLB-L
-B------L---Lb-L
-B------L--ELb-L
-bbbbbbbbBbBbB-L
bbbBbB---------L
---------------L
---------------L
---------G--G-ML
------Lbbbbbbbbb