B---------------
B---------------
B---------------
B---------------
B---------------
B---------------
B------G--------
B-BBBB-BBBBBBBBB
B-------------GR
B------------Lbb
B----------G-L--