bbbG-L---BbLbB--
bbbbGLE--BbLbB--
bbbbbL---BbLbB--
-----L---BbLbB--
-----L---BbLbB--
-----L---BbLbB--
-----L---BbLbB--
-----L---BbLbB--
-----L---BbLbB--
-----L---M-L----
bbbbbbbbbbbbbbbb