------BLBBBBLBB-
-------L--------
-------LG---G---
-----BBLBBBBBBLB
--------------L-
-------G-----GL-
----BLBBBBBBBBBB
-----L----------
-----L----------
-----L-G-----G--
bbbbbbbbbbbbbbbb