GG-Gbb--LLb-----
bbbbb---LLb-----
bbbb---bLLb-----
Lbb---bLLLb-----
Lb--GLLLGLb-----
L---bLLLLbb-----
L---LLLELLb-----
L-LLLG--LLb-----
LbLLbbbbbLb-----
LLL------L------
LLbbbbbbbbb-----