----------------
----------------
---------------G
--------GGGGGG-B
--------bbbbbbb-
----------------
----------------
----------------
GGGG------------
bbbbL-----------
bbbbbbbL--------