L--Lbb--G-bbbbbb
LbbLbbbbbbbbbbbb
L-----bRRRRRRRRR
L-----b---------
LGEL--b---------
bbbL--b---------
---L--b-----G---
---L--b---G-bb--
---L--b-G-bb----
---L-Mbbbb------
bbbbbbbbbbbbbbbb