----------------
LbbbbbbbbbbG----
L--------b-bRRR-
b----G---b-bE--L
b--------b--bb-L
b--------b-----L
bBB------b-----L
-bb------b-----L
-bb------b-----L
RR-------L-----L
---------L-----L