----------------
----------------
----------------
----------------
--------------Lb
--------------Lb
------------EGLb
------------Lbbb
-----------GLbbb
----------Lbbbbb
--------EGLbbbbb