------------L--L
------------Lbbb
------------L---
----G-------L---
bbbbbbbbbb--L---
------------L---
------------L---
------------L---
------------L---
------------L---
bbbbbbbbbbbbbbbb