----------------
----------------
----------------
----------------
----------------
----------------
----RRRRRR------
-bbb------LRR---
-bG------LRR-bbb
-bbb-----RR--bbb
-----bbbb----bbb