----------------
----------------
BBBBBBBL--------
-------L---E----
-------Lbbbbbbbb
-------L--------
---b---L--------
--b--RRL--------
--b-G-GL----GbG-
--b-bGbLRR--b-b-
-b--bGbLG-GRRGb-