R---------------
-LE-------------
LLL-------------
LLL-------------
L---------------
LLL--RRRRRRRR---
L--LL----E------
L-------LLLLL---
LL------GGGGG---
-LL-----LLLLL---
-LL-----GGGGG---