----------------
----------------
----------------
----------------
----------------
----------------
----------------
----E-----------
LBBBBB-BBBBBBBLB
L-------RRR---LB
bbLbb-bb--LbE-L-