BG----------L---
BBbL-b----b-L---
--BL--bGGb--L---
--BL---bbLRRL-G-
--BL-----L--bbbb
--BL--E--L------
--BLBBBBBBBBL-G-
--BLb--G-G-bLbbb
--BLbLbBbBbbL---
---LbL-G-G--L---
bbBBbbBbBbBbBbBb