--------------b-
--------------b-
--GGGGGGGGG-E-b-
-BBBBBBBBBBBBBb-
----------------
-------GG-------
----BBLBB-------
----G-LG--------
---BBBBBLB------
--------L-------
------GGL-------