----------------
----------------
-------LRRRLbbbb
-------L----b---
GRRRRRRL----b---
bL----------b---
bbL-------E-b---
bbbL------G-b---
bbbbL-RRRRRRbG--
BBBBBBL-----bbbb
------L-----bbbb