L-----L------L--
L---E-L-G----Lbb
BBbbbBbBBbbBBL--
BbbbBB-------L--
B---BB-------L--
BG--BB-------L--
bbbbbbbbbLbbbbBB
---------L------
---------L------
---------L------
bbbbbbbbbbbbbbbb