b----b-----bbBBB
b-G--BBLb-------
bbbb---Lb-------
b--b---LbbBBBBb-
b--bBBbL------bb
b-----bL--------
b--LbbbbBBbbbL-G
b--Lb------Gbbbb
b--Lb-----------
b--Lb-----------
b-GLbBbbbbBBbbbb