-----------E----
-G------b-b-b---
bbbbbbbbb-b-b---
--------b-b-b---
----G---b-b-b---
--bbbbbbb-b-b---
--G-------b-b---
---RRRRRR-b-b---
-Gb-----L-------
bbb-----LRR-----
bbb-----L-------