----------------
----------------
----------------
----------------
-RRRRRRRRRRRRGLb
-------------Lbb
RR-RRRRRRRRLLbbb
----------GLbbbb
RRRRRRRRRLLbbbbb
--------ELbbbbbb
-RRRRRRLLbbbbbbb