----------------
RRRRRRRRRRRRR---
----G--G---BL---
bbbbbbbbbbbBBBBB
BbbBbbbBbBBBB---
-----------bB---
-----------bb---
RRRRRRRRRL-bb---
---------L-bBbbb
---------L-bB---
---------L-BB---