bG-L--LLLLLLLLLL
-bGL--L---------
--bL--LG-G-G-G-G
---bG-Lbbbbbbbbb
----b-L---------
------L-L-L-L-L-
------L---------
-------L-L-L-L-L
--------L-L-L-L-
----E-------G--b
bbbbbbbbbbbbbbbb