----------------
----------G---G-
---LbbbbbbbbbbbL
---L-----------L
-G-L---G-----G-L
BbbbBBBbbbBBbBbb
RRRRRRRRRRRRRRRR
-----G----G-E--L
-BbbbbBBbbBBbbbL
-B-------------L
-B------G---G--L