----------------
----------------
G--------G------
L------bbbbbLbbb
L-----------L---
L---E-------L---
bbbbbbbbbbbbbbBB
--------------bG
--------------bL
RRRRRRRRRG----BL
--------bbbbLBBL