----------------
--G-------------
bbbbL-----------
----L-----------
G---L-----------
bbbbbbbbLbbbbbbb
--------L-------
------G-L-------
bLbbbbbbL----G--
-L--G---LBBBBBBB
bLbbbbbbL-------