bbbL-GbLRRRRRbbb
bbbLbbbL-G-L-bbb
RRRLbGbLbbbL-bbb
---LbbbL---L-bbb
---LbbbLRRRL-bbb
---LbGbL-G-L-bbb
---LbbbLbbbL-bbb
---LbbbL---L-bbb
---LbbbL---L-bbb
-G-LbbbL--EL-bbb
bbbbbbbbbbbbbbbb