----------------
----------------
----------------
bbbbbbbbbbbbbbbb
BL-b---LRRRRRRR-
BL-bLBBL--------
-LG-L----------G
-L--LRRRRRR-----
-L--L-------bbbb
-L--L-----------
bbLBL-----------