bL----L---L-----
bL----L---L-----
bL----L---L-----
bbL---L---L-----
-bbbL-L---L-----
---bbbLL--LbbbbL
L----bbLbb-----L
bBL----Lb------L
bbBBBBLLbbb----L
-G--G-LLbG-----L
bbbbbbLLbbbbbbbL