----------------
-BBBBBBB--------
-B-----B--------
-B-----B--------
-B-----B--------
-bbbLbbb--------
----L-----------
----L-----------
---BLGLbbbbLbLE-
--GBbLbbbbbLbbbb
---BbL----BL----