----L--BLB------
----L-BGLGB-----
bbbbL-BBLBB-----
----L---L-------
----L---L-------
----L---L-------
bbbbL---L-------
----L---L-------
----L---L-------
----L--EL-------
---MLbbbbbbbbbbb