----------------
----------------
----------------
----------------
----------------
----------------
----------L-E---
bbb-----bbLbb---
bbbb---bbGLGbb--
--Gbb--b--L-----
-------bbGLG----