--BBLBBBBBB-----
----L-----------
----LG---G------
-BBBLBBBBBLB----
----------L-----
R---G---G-L-----
-BBBBBBBBBBBB---
----------------
----------------
----G---M-G----E
bbbbbbbbbbbbbbbb