---G-G----b-L-L-
---bbLbLbbbbbbL-
--Gb-LbL------L-
--b-LLbLLLLLLLL-
--bLEG-bLLLLLLLb
---bbbL-bL----L-
-----bbLbbbbbbbL
----bb-L-----G-L
----b-LbbLLLLLLb
---G-LbbbLLLbLLL
bbbbbbbbbbbbbbbb