--------L-------
--------L-------
-----R-GL-------
----L-bbL---G---
----L------bbb--
-G--L-----G-----
LbbbL----bbb----
L---------------
L---------------
L--------------M
bbbbbbbbbbbbbbbb