----------------
bbbbbL------L---
-G---LRRRRRRL---
bbbbbb------L---
------------L--G
------------Lbbb
RRRL--------L---
---L--------L---
---L--------L---
E--L-G---E--L--G
bbbBBBBBbbbbLbbb