---------------L
---------------L
------G--------L
bbbbbbbbbL-----L
---------L-G---L
---------LbbbbbL
---------L------
---------L------
RRRRR---EL------
----LbbbbBBBBBBL
----L----------L