LbG-bL------Lbbb
Lbbbb-------LRLb
LLbb----------Lb
-Lbb----------Lb
-Lbb----------Lb
-Lbb----------Lb
-Lbb----------Lb
-Lbb----------Lb
-LbbbbbbbbbbbbLb
GLbb------G--bL-
BBBBBBBBBBBBBBBB