E---------------
----------------
----------------
--LLLLLR-LLL----
-----L--L---L---
L----L--L-G-L---
LRL--L--LLLLL---
--L-GL--L---L---
---LLL--L---L-L-
G---------G-L---
bbbbbbbbbbbbbbbb