bb-LRRRLEbLb---L
bbbbbbbbb-LbbbbL
-bbb----GbL----L
RRRRRLRRRRLRRRRL
---b-L-L-b-----L
-bBbbB-LBbbBbbbL
-b---b-Lbb---bbL
-RR-RR-LbRR-RRbL
---G---L---G---L
---B---L---B---L
--bBb--L-bbBbb-L