----------------
----------------
----------------
----------------
----------------
------------bbb-
----G-E-G---BBB-
LbbbbbbbbbbbbbbL
LRRRRRRRRRR-bbbL
-----------LBBBL
-----------LbbbL