----------------
----------------
RRRRRRRRRRRRL---
------------L---
------------L---
------------L---
bbLbbGG----bb---
bbLbbbb----bb---
bbLbbbb----bb---
bbLbbbbG---bb---
bbLbb-bb---bb---