----------------
-----RRRRRRRRRRR
L--GE-----------
Lbbbbbb---------
L-----b---------
L-----b---------
L-----b---------
L--L--b-------RR
L-GL--b-G-------
LbbLG-bbbbbbbb-G
---Lbbbbbbbbbbbb