b---Lb-bBBBBBbbB
b--GLb----------
b--bLb-----E----
b--bLbBBBBBBBBBB
b--GL-----------
b--bLRRRRRRRRRRR
b--bBBBbbLBBBBBb
b---E----L----BB
bbBBBBBbbbBBBBbb
----------------
---------M------