bbbbbL----------
----bL--E-------
----bL-bLbb-----
----bbbbLbbL----
bbbbbbbbLbbL----
bbb-G---LG-bbbL-
---bbL--LbLG-bL-
bL---L--L-bbLbL-
bbLG-L--LGbbLbL-
bbbbbbbbbbbbbbLM
BBBBBBBBBBBBBBBB