Lb----------G-Lb
Lb-G---LbL-Lbbbb
bbbb---Lbbbbb---
---b---Lb-------
---b---Lb-------
---b---Lb-------
---b---Lb-------
---b--GLb-------
---bbbbbb-------
-------M--------
BbBbBbBbBbBbBbBb