----------------
----------------
----------------
----------------
----------------
----------------
----------------
-------E--------
---G-LbbbbbL----
bLbbLb----bL----
-L-BLbbbbbbLbbbL