--------------E-
----------------
----------------
----G--------bbL
--LbbbL------LLL
-Lb-G-bL-LbbLLLL
-LbbbbbbLbbLLLLL
----------LLLLLG
-----E----LLLLLL
-bbbbbbbbbLLLLLL
-bbGbb----bLLLLL