BBBbbbbBBBbBB---
---L------LRRRRR
--EL------L-----
BBB-BBBBBbbbbbbB
BRRL--------LRRR
B--L--------Gbb-
G-bL--------LbbG
BbbLRRRRRRRRLRRR
B--b--------L---
BG-b--------L---
BBbb-----GGGL---