---------RRRRLLL
-------------LLL
-------------LLL
G-G-G-G-G-G--LLL
-------------LLL
-------------LLE
bbbbbbbbbbbbbLLb
bbbbbbbbbbbbbLLb
--------------L-
-G-G-G-G-G----L-
bbbbbbbbbbbbbbbb