----------------
----------------
----------------
----------------
----------------
----------------
----GE---G------
bbbbbbbbbbbbbbbb
--RRRRRRRRRRRRR-
---------------L
-------------GLb