L-L-b----G-G----
LbbbbbbLbLbb----
L------LbL-b----
LLLLLLLLbLL-b---
LLLLLLLb-GELb---
L----Lb-Lbbb----
bbbbbbbLbb------
-G-----L-bb-----
LLLLLLbbL-b-----
LLbLLLbbbLMG----
bbbbbbbbbbbbbbbb