L--R-L-ELRR--L--
L-R--R--L----L--
LR----R-LR---L--
L-R-G--RL----L-R
LR-RL--------LR-
L-R-L---R----LG-
L--RL-R--R---LR-
LRR-L-----R--L-R
L--RL----R-R-L--
L---L---R---RL--
----L-----G-----