bL--b----b--Lbb-
bL--b----b--Lbb-
bL--bG---b--Lbb-
bLbbbbbbbbbbLbbb
bL---b-bG---LL--
bLbbbbbbbbbb-Lbb
bL--Gbbb-----L--
bL-----------L--
bL-----------L--
bL--------E--L--
bbbbbbbbbbbbbbbb