----------------
----------------
-------G------G-
---LbbbbbbLb--bL
bbbL------L----L
---L------L--G-L
--bLb----bbbbb-L
-bb------------L
bb-------------L
b-----------Lb-L
----------LbL--L