----------------
----------------
----------------
------G-----G---
bbbbbbbbbbbbbbbb
bbbbbbbbbbbbbbbb
-----G-E----E--G
Lbbbbbbbbbbbbbbb
L-----------G---
bbbbbbbbbbbbbbbb
----------------