b----LER-R-R-RL-
b----LbbbbbbbbLM
b----L--------bb
b----L--------bG
b----L--------b-
b--G-L--------b-
L----L------E-b-
LRRRRLbbbbbbbbL-
L--G--L-------L-
L-----L----G--L-
bbbbbbbbbbBBBbbb