---b-----Lb---bL
---b-----Lb---bL
bbLb-----Lb---bL
--LbRRRRRLb---bL
--LbL-----b---bL
GELbL-----b-G-bL
BBBbL-----bbbbbL
----L----bb----L
----L---bb-----L
M---L--bb------L
bbbbbbbbbbbbbbbb