---------------L
------M----E---L
Lbbbbbbbbbbbbbbb
L---------------
LRRRRRRRRRRRRRR-
bbb--bb--bb--bbL
BBBBBBBBBBBBBBBL
RRRRRRRRRRRRRRRL
bbbbbbbbbbbbbbbb
----------------
-----------E----