L-E-GG-b--b--Gb-
Lbbbbbbb--bbbbbb
Lb--b-bbbbb-----
Lb-Gb-G--b---LG-
LbbbbbbbbbbbBLBb
L------------L--
L------------L--
L------------L--
L------------L--
L--------G---L--
bbbbbbbbbbbbbL--