----------------
----------------
----------------
G---------------
bLRRRRRRRRRRRRRR
bbLGE-----------
bbbLLRRRRRRRRRRR
bbbbL-----------
bbbbbLLRRRRRRR-R
bbbbbbLG--------
bbbbbbbLLRRRRRRR