----------------
----------------
----------------
----------------
RRR-LLbbL-------
---LLbbLL-------
--LLbbLLG-------
-LLbbLLG-BB-----
LLbbLLG-BB------
LbbLLG-BB-------
bbLLG-BB-GG-----