L-----L--G------
L-----bbbbbbLBBB
LRRRR-------L---
L-----------L---
---EG-------L---
bbbbbbbbbL--L---
--------bbbbbbLB
--------------L-
--------------L-
-G---M--------L-
bbbbbbbbbbbbbbL-