----------------
----------------
LRRRRRRRRRRRRRRR
L---------------
L---------------
L---------------
bbbbbbbbbLbbbbbb
bbbbbbbbbLbbbbbb
---bbb---Lbb----
---bbb---Lbb----
---bbb---Lbb----