----------------
----------------
----------------
----------------
----------------
----------------
---G-RRR--------
bbbbbb--L-------
-----G--L-------
bbbbbbbbbb------
----b----b------