-------------LRR
-------------L--
-------------L--
-------------L--
RRRRRRRRRRR-bL--
----GbbG---LbLbB
---Gb--bG--LbL--
--Gb----bG-LbbBb
-Gb------bGLbBBB
-b--------bL----
----------------