----------------
----------------
RRRRRRRRRRRRRGGG
-------------bbb
-------------bbb
-------------bbb
-------------bbb
-----GGG-----bbb
-----bbb-----bbb
-----bbb-----bbb
-----bbb-----bbb