----------------
-G--------------
bbbbbbbbbL------
---------L------
---------LBBBBBB
---------L------
---G-----L------
bbbbbLbbbb------
-----L----RR----
-----L------RR--
-E---L--------RR