-RRRRRRRRRRRR--G
L-----------bbbb
L------------M-G
L-----------LBBB
L-----------L---
L-----------L--G
L-----------bbbb
L---------------
LbbbbbbbbL-----G
L--------L--LBBB
L-------LL--L---