bbbbbbbbbbb-----
---E------b-----
bbbbbbbbb-b-----
RRRRRRR---b-----
-G-----bL-b-----
-------bL-b-----
-------bL-b-----
-------bL-b-----
------GbL-L-----
-----GbbLLL-----
----Gbb-LLb-----