----------------
----------------
----------------
----------------
----------------
----------------
----------------
----------------
---------------L
---------------L
G-RL---LR-G-RLRL