--bbb------bLLLL
---b--------bLLL
-------------bLL
--------------bL
--------------bL
--------------bL
--------------bL
--------------bL
---------------L
----E----------L
-bbbbbbbbbbbbbbL