--bL-----G---bLb
bLbbbbbbbbbbbbLb
bL-----------bLb
bL------G----bLb
bbbbbbbbbbbbLbLb
--b---------LbLb
--b---------LbLb
G-b-----G---LbLb
bbbbbbbbbbbbbbLb
---L----------Lb
-G-L----G-----Lb