---------------b
RRRRRRRRRRRRRR-b
bbbb-----------b
---bbbG--------b
-----bbb-------b
GGGGEGGbbbG----b
bbbbbbbbbbbbbbbb
------------bbbb
--------------bb
---------------b
---------------b