----------------
----------------
----------------
------------GE--
--------GE--bbbL
LbbbbL--bbbb---L
LG---L---------L
LL---L---------L
L----L---------L
LG---L---------L
LL-------------L