BbbLGLbbbbbLbbbb
BbbbbbbbbBbLbbbB
b-------bbLLLbbb
B-------bLLLLL--
BRRRRRRRbLL-LLRR
bB--bBbBbL---L--
bbbG-bBbBL---L--
BbbB--bBbL---L--
bbbbB--BbL---L--
bBBBBb---L---L--
bbbbbbbbBLG-GLBB