---L-----G------
--bbbbLbbb------
------L---------
------L---------
------L---------
---E--L---------
bbbbbbbbbbbbLbbb
------------L---
------------L---
--M---------L---
bbbbbbbbbbbbbbbb