bbbBBbbbbbbbbbbb
b-G-B----G-M----
bLbLBbbLbbbbbbbb
bLbL-bbLGRRRRRRR
bLbL-bbLbG------
bLbL-bbLbbG-----
bLbbL-bLLbbG----
bL-bL-bLLLbbG---
bL-bbL-bbLLbbG--
bL--bL--bbLLbbG-
bL--bbL--bbLLbbG