--------E-------
----------------
G----LbbbbL-b-bL
bbLB-LB---L-b-bL
G-LB-LBLB-L-b-bL
bbbB-LBLB-L-b-bL
G--B-LBLB-L-b-bL
bbLB-LBLB-L-b-bL
G-LB-LBLB-L-b-bL
bbbB-LBLB-L-b-bL
G--B-LBLB-L-b-bL