EG--G-----G-----
bbbbbbbbbbbbbbbb
----------------
----------------
----------------
----------------
b---------------
G---------------
----------------
bb--------------
-G--------------