b-b--bLb--bL---L
b-b--bLb--bL---L
--b--bL-RRbbbbbL
--b--bLb--bL---L
--b--bLb--bL---L
bbb--bLb--bLbbbb
-----bLb--bL---L
-----bLb--bL---L
bbbbbbLb--bbbbbL
------Lb-------L
bbbbbbbb--E----L