bbbbGRRRRRRRRRRL
LLLbbGG--------L
LLLLLbbG-------L
-LLLLLbb-------L
-ELLLLLb-------L
---LLLLbG------L
----LLLbb------L
----GLLLb------L
-----GLLb------L
-----GGLb------L
-----GLLb------L