----------------
-----E----------
---------------M
---GLG----------
--GLLLG---------
-GLLLLLG--------
GLLLLLLLG-------
LLLLLLLLL-------
LLLLLLLLLRR---GE
LLLLLLLLL-bbbbbb
LLLLLLLLL-b-G---