----------------
----------------
----------------
----------------
BBBBBBBBBBBBBB--
------RRRRRRRR--
----------------
----------------
----------------
--E----------Lb-
bbbbbbbbb--G-Lb-