-----Gbb---LbL--
---G-bb---LbLL--
--bbbb---LbLLL--
--b-----LbLLLG--
--b----LbLLLG---
bbb---LbLLLG----
L----LbLLLG-----
L---LbLLLG------
L--LbLLLG-------
L-LbbLLG-----E-G
bbbbbbbbbbbbbbbb