-----L----------
-----L----------
--RRRL-EG-------
-RRRRbbbbLbL----
RRRRGbG---bL----
B---BbbbbbbL----
----BBBB-RRL----
G-------LB-L----
BBBBLbbBLB------
----L---LB------
bbbbLbbBLB------