----------------
------------GR-R
------------b-L-
-------------BLB
---L----------L-
---LbbbbbbbbbbL-
---L----------L-
---L--------M-L-
---L------GG--Lb
---L-b----GG--L-
---L-----GGGG-L-