RRLBL----G------
GBLBbb----------
bbLB-L-------E--
--LRRLBBBBBBBBBB
bbbb-L---BRRRRRB
bG--bbbL-B-L---B
b------L---L---B
bbbbbbbbbbbLB--B
b----------L---B
BL-G----G--L---B
GLBBbbbbBBBL--GB