----------------
----------------
----------------
----------------
---G-------Lb---
LbbbbbLRRRRLb---
Lb---bL----Lb---
Lb---bL-----b---
Lb---bL-----b---
Lb-G-bL-----b---
LbbbbbL-----b---