L--------------L
L---------------
L--------------G
L--------------L
L--------------L
L---------------
L--------------G
L--------------L
L---------------
L----------M---G
L-------Lbbbbbbb