LLL-L-----------
LLL-L-----------
LLL-L-----------
EG--L-----------
bbbL------G-----
LLL-----Lbbbbbbb
--------L-------
--------L-------
--------L-------
G---M---L-------
bbbbbbbbbbbbbbbb